crime,subcrime,year,total,no_arrest,arrest
ARSON,AGGRAVATED,2008,194,160,34
ARSON,AGGRAVATED,2009,160,136,24
ARSON,AGGRAVATED,2010,155,122,33
ARSON,AGGRAVATED,2011,74,60,14
ARSON,AGGRAVATED,2012,55,40,15
ARSON,AGGRAVATED,2013,51,40,11
ARSON,AGGRAVATED,2014,47,41,6
ARSON,AGGRAVATED,2015,77,56,21
ARSON,AGGRAVATED,2016,71,53,18
ARSON,AGGRAVATED,2017,56,43,13
ARSON,AGGRAVATED,2018,57,42,15
ARSON,ATTEMPT ARSON,2008,208,188,20
ARSON,ATTEMPT ARSON,2009,194,162,32
ARSON,ATTEMPT ARSON,2010,185,172,13
ARSON,ATTEMPT ARSON,2011,88,77,11
ARSON,ATTEMPT ARSON,2012,84,77,7
ARSON,ATTEMPT ARSON,2013,65,55,10
ARSON,ATTEMPT ARSON,2014,46,42,4
ARSON,ATTEMPT ARSON,2015,57,52,5
ARSON,ATTEMPT ARSON,2016,70,61,9
ARSON,ATTEMPT ARSON,2017,50,45,5
ARSON,ATTEMPT ARSON,2018,36,29,7
ARSON,BY EXPLOSIVE,2010,12,10,2
ARSON,BY EXPLOSIVE,2011,1,0,1
ARSON,BY FIRE,2008,842,792,50
ARSON,BY FIRE,2009,844,772,72
ARSON,BY FIRE,2010,641,570,71
ARSON,BY FIRE,2011,337,317,20
ARSON,BY FIRE,2012,323,300,23
ARSON,BY FIRE,2013,240,219,21
ARSON,BY FIRE,2014,291,271,20
ARSON,BY FIRE,2015,305,284,21
ARSON,BY FIRE,2016,355,340,15
ARSON,BY FIRE,2017,332,312,20
ARSON,BY FIRE,2018,246,241,5
ARSON,POS: CHEMICAL/DRY-ICE DEVICE,2008,12,8,4
ARSON,POS: CHEMICAL/DRY-ICE DEVICE,2009,8,4,4
ARSON,POS: CHEMICAL/DRY-ICE DEVICE,2010,1,0,1
ARSON,POS: CHEMICAL/DRY-ICE DEVICE,2012,1,0,1
ARSON,POS: EXPLOSIVE/INCENDIARY DEV,2008,14,4,10
ARSON,POS: EXPLOSIVE/INCENDIARY DEV,2009,10,4,6
ARSON,POS: EXPLOSIVE/INCENDIARY DEV,2010,16,8,8
ARSON,POS: EXPLOSIVE/INCENDIARY DEV,2011,5,3,2
ARSON,POS: EXPLOSIVE/INCENDIARY DEV,2013,6,2,4
ARSON,POS: EXPLOSIVE/INCENDIARY DEV,2014,2,0,2
ARSON,POS: EXPLOSIVE/INCENDIARY DEV,2015,5,4,1
ARSON,POS: EXPLOSIVE/INCENDIARY DEV,2016,4,3,1
ARSON,POS: EXPLOSIVE/INCENDIARY DEV,2017,3,2,1
ARSON,POS: EXPLOSIVE/INCENDIARY DEV,2018,1,0,1
ASSAULT,AGG PO HANDS NO/MIN INJURY,2008,796,190,606
ASSAULT,AGG PO HANDS NO/MIN INJURY,2009,1034,160,874
ASSAULT,AGG PO HANDS NO/MIN INJURY,2010,1073,177,896
ASSAULT,AGG PO HANDS NO/MIN INJURY,2011,528,42,486
ASSAULT,AGG PO HANDS NO/MIN INJURY,2012,520,60,460
ASSAULT,AGG PO HANDS NO/MIN INJURY,2013,468,49,419
ASSAULT,AGG PO HANDS NO/MIN INJURY,2014,472,38,434
ASSAULT,AGG PO HANDS NO/MIN INJURY,2015,415,40,375
ASSAULT,AGG PO HANDS NO/MIN INJURY,2016,270,35,235
ASSAULT,AGG PO HANDS NO/MIN INJURY,2017,245,24,221
ASSAULT,AGG PO HANDS NO/MIN INJURY,2018,211,39,172
ASSAULT,AGG PRO.EMP: HANDGUN,2008,48,32,16
ASSAULT,AGG PRO.EMP: HANDGUN,2009,44,24,20
ASSAULT,AGG PRO.EMP: HANDGUN,2010,31,23,8
ASSAULT,AGG PRO.EMP: HANDGUN,2011,26,18,8
ASSAULT,AGG PRO.EMP: HANDGUN,2012,11,4,7
ASSAULT,AGG PRO.EMP: HANDGUN,2013,13,4,9
ASSAULT,AGG PRO.EMP: HANDGUN,2014,22,14,8
ASSAULT,AGG PRO.EMP: HANDGUN,2015,15,13,2
ASSAULT,AGG PRO.EMP: HANDGUN,2016,29,15,14
ASSAULT,AGG PRO.EMP: HANDGUN,2017,40,27,13
ASSAULT,AGG PRO.EMP: HANDGUN,2018,32,23,9
ASSAULT,AGG PRO.EMP: OTHER DANG WEAPON,2008,158,108,50
ASSAULT,AGG PRO.EMP: OTHER DANG WEAPON,2009,162,92,70
ASSAULT,AGG PRO.EMP: OTHER DANG WEAPON,2010,119,74,45
ASSAULT,AGG PRO.EMP: OTHER DANG WEAPON,2011,83,45,38
ASSAULT,AGG PRO.EMP: OTHER DANG WEAPON,2012,25,12,13
ASSAULT,AGG PRO.EMP: OTHER DANG WEAPON,2013,22,14,8
ASSAULT,AGG PRO.EMP: OTHER DANG WEAPON,2014,39,21,18
ASSAULT,AGG PRO.EMP: OTHER DANG WEAPON,2015,45,26,19
ASSAULT,AGG PRO.EMP: OTHER DANG WEAPON,2016,39,25,14
ASSAULT,AGG PRO.EMP: OTHER DANG WEAPON,2017,48,32,16
ASSAULT,AGG PRO.EMP: OTHER DANG WEAPON,2018,71,43,28
ASSAULT,AGG PRO.EMP: OTHER FIREARM,2008,20,16,4
ASSAULT,AGG PRO.EMP: OTHER FIREARM,2009,12,8,4
ASSAULT,AGG PRO.EMP: OTHER FIREARM,2011,4,1,3
ASSAULT,AGG PRO.EMP: OTHER FIREARM,2014,4,1,3
ASSAULT,AGG PRO.EMP: OTHER FIREARM,2015,4,2,2
ASSAULT,AGG PRO.EMP: OTHER FIREARM,2016,2,1,1
ASSAULT,AGG PRO.EMP: OTHER FIREARM,2017,1,0,1
ASSAULT,AGG PRO.EMP:KNIFE/CUTTING INST,2008,60,34,26
ASSAULT,AGG PRO.EMP:KNIFE/CUTTING INST,2009,90,50,40
ASSAULT,AGG PRO.EMP:KNIFE/CUTTING INST,2010,79,45,34
ASSAULT,AGG PRO.EMP:KNIFE/CUTTING INST,2011,40,26,14
ASSAULT,AGG PRO.EMP:KNIFE/CUTTING INST,2012,24,14,10
ASSAULT,AGG PRO.EMP:KNIFE/CUTTING INST,2013,21,11,10
ASSAULT,AGG PRO.EMP:KNIFE/CUTTING INST,2014,28,16,12
ASSAULT,AGG PRO.EMP:KNIFE/CUTTING INST,2015,17,8,9
ASSAULT,AGG PRO.EMP:KNIFE/CUTTING INST,2016,39,21,18
ASSAULT,AGG PRO.EMP:KNIFE/CUTTING INST,2017,40,21,19
ASSAULT,AGG PRO.EMP:KNIFE/CUTTING INST,2018,47,30,17
ASSAULT,AGGRAVATED PO: HANDGUN,2008,154,60,94
ASSAULT,AGGRAVATED PO: HANDGUN,2009,156,34,122
ASSAULT,AGGRAVATED PO: HANDGUN,2010,116,31,85
ASSAULT,AGGRAVATED PO: HANDGUN,2011,78,19,59
ASSAULT,AGGRAVATED PO: HANDGUN,2012,68,17,51
ASSAULT,AGGRAVATED PO: HANDGUN,2013,38,13,25
ASSAULT,AGGRAVATED PO: HANDGUN,2014,58,21,37
ASSAULT,AGGRAVATED PO: HANDGUN,2015,54,16,38
ASSAULT,AGGRAVATED PO: HANDGUN,2016,57,27,30
ASSAULT,AGGRAVATED PO: HANDGUN,2017,37,18,19
ASSAULT,AGGRAVATED PO: HANDGUN,2018,35,16,19
ASSAULT,AGGRAVATED PO: OTHER DANG WEAP,2008,132,42,90
ASSAULT,AGGRAVATED PO: OTHER DANG WEAP,2009,216,52,164
ASSAULT,AGGRAVATED PO: OTHER DANG WEAP,2010,182,56,126
ASSAULT,AGGRAVATED PO: OTHER DANG WEAP,2011,111,32,79
ASSAULT,AGGRAVATED PO: OTHER DANG WEAP,2012,56,6,50
ASSAULT,AGGRAVATED PO: OTHER DANG WEAP,2013,62,17,45
ASSAULT,AGGRAVATED PO: OTHER DANG WEAP,2014,54,10,44
ASSAULT,AGGRAVATED PO: OTHER DANG WEAP,2015,72,17,55
ASSAULT,AGGRAVATED PO: OTHER DANG WEAP,2016,45,18,27
ASSAULT,AGGRAVATED PO: OTHER DANG WEAP,2017,65,25,40
ASSAULT,AGGRAVATED PO: OTHER DANG WEAP,2018,45,17,28
ASSAULT,AGGRAVATED PO: OTHER FIREARM,2008,10,0,10
ASSAULT,AGGRAVATED PO: OTHER FIREARM,2009,22,4,18
ASSAULT,AGGRAVATED PO: OTHER FIREARM,2010,14,6,8
ASSAULT,AGGRAVATED PO: OTHER FIREARM,2011,4,0,4
ASSAULT,AGGRAVATED PO: OTHER FIREARM,2012,4,2,2
ASSAULT,AGGRAVATED PO: OTHER FIREARM,2013,3,2,1
ASSAULT,AGGRAVATED PO: OTHER FIREARM,2014,3,2,1
ASSAULT,AGGRAVATED PO: OTHER FIREARM,2015,3,0,3
ASSAULT,AGGRAVATED PO: OTHER FIREARM,2016,2,1,1
ASSAULT,AGGRAVATED PO: OTHER FIREARM,2017,2,1,1
ASSAULT,AGGRAVATED PO: OTHER FIREARM,2018,2,1,1
ASSAULT,AGGRAVATED PO:KNIFE/CUT INSTR,2008,58,34,24
ASSAULT,AGGRAVATED PO:KNIFE/CUT INSTR,2009,94,50,44
ASSAULT,AGGRAVATED PO:KNIFE/CUT INSTR,2010,92,43,49
ASSAULT,AGGRAVATED PO:KNIFE/CUT INSTR,2011,49,21,28
ASSAULT,AGGRAVATED PO:KNIFE/CUT INSTR,2012,35,19,16
ASSAULT,AGGRAVATED PO:KNIFE/CUT INSTR,2013,31,16,15
ASSAULT,AGGRAVATED PO:KNIFE/CUT INSTR,2014,36,19,17
ASSAULT,AGGRAVATED PO:KNIFE/CUT INSTR,2015,28,13,15
ASSAULT,AGGRAVATED PO:KNIFE/CUT INSTR,2016,32,25,7
ASSAULT,AGGRAVATED PO:KNIFE/CUT INSTR,2017,26,16,10
ASSAULT,AGGRAVATED PO:KNIFE/CUT INSTR,2018,26,15,11
ASSAULT,AGGRAVATED: HANDGUN,2008,5166,3834,1332
ASSAULT,AGGRAVATED: HANDGUN,2009,4864,3608,1256
ASSAULT,AGGRAVATED: HANDGUN,2010,4066,2987,1079
ASSAULT,AGGRAVATED: HANDGUN,2011,2043,1495,548
ASSAULT,AGGRAVATED: HANDGUN,2012,2080,1482,598
ASSAULT,AGGRAVATED: HANDGUN,2013,1777,1299,478
ASSAULT,AGGRAVATED: HANDGUN,2014,1795,1331,464
ASSAULT,AGGRAVATED: HANDGUN,2015,1972,1508,464
ASSAULT,AGGRAVATED: HANDGUN,2016,2855,2357,498
ASSAULT,AGGRAVATED: HANDGUN,2017,2890,2371,519
ASSAULT,AGGRAVATED: HANDGUN,2018,2753,2281,472
ASSAULT,AGGRAVATED: OTHER DANG WEAPON,2008,2994,2120,874
ASSAULT,AGGRAVATED: OTHER DANG WEAPON,2009,2888,1964,924
ASSAULT,AGGRAVATED: OTHER DANG WEAPON,2010,2632,1909,723
ASSAULT,AGGRAVATED: OTHER DANG WEAPON,2011,1216,799,417
ASSAULT,AGGRAVATED: OTHER DANG WEAPON,2012,1088,769,319
ASSAULT,AGGRAVATED: OTHER DANG WEAPON,2013,907,639,268
ASSAULT,AGGRAVATED: OTHER DANG WEAPON,2014,918,611,307
ASSAULT,AGGRAVATED: OTHER DANG WEAPON,2015,948,673,275
ASSAULT,AGGRAVATED: OTHER DANG WEAPON,2016,1000,767,233
ASSAULT,AGGRAVATED: OTHER DANG WEAPON,2017,1088,845,243
ASSAULT,AGGRAVATED: OTHER DANG WEAPON,2018,1068,855,213
ASSAULT,AGGRAVATED: OTHER FIREARM,2008,216,122,94
ASSAULT,AGGRAVATED: OTHER FIREARM,2009,196,118,78
ASSAULT,AGGRAVATED: OTHER FIREARM,2010,163,99,64
ASSAULT,AGGRAVATED: OTHER FIREARM,2011,111,67,44
ASSAULT,AGGRAVATED: OTHER FIREARM,2012,87,47,40
ASSAULT,AGGRAVATED: OTHER FIREARM,2013,78,41,37
ASSAULT,AGGRAVATED: OTHER FIREARM,2014,74,36,38
ASSAULT,AGGRAVATED: OTHER FIREARM,2015,83,55,28
ASSAULT,AGGRAVATED: OTHER FIREARM,2016,101,75,26
ASSAULT,AGGRAVATED: OTHER FIREARM,2017,86,56,30
ASSAULT,AGGRAVATED: OTHER FIREARM,2018,94,70,24
ASSAULT,AGGRAVATED:KNIFE/CUTTING INSTR,2008,3424,2348,1076
ASSAULT,AGGRAVATED:KNIFE/CUTTING INSTR,2009,3126,1988,1138
ASSAULT,AGGRAVATED:KNIFE/CUTTING INSTR,2010,2568,1737,831
ASSAULT,AGGRAVATED:KNIFE/CUTTING INSTR,2011,1390,913,477
ASSAULT,AGGRAVATED:KNIFE/CUTTING INSTR,2012,1393,914,479
ASSAULT,AGGRAVATED:KNIFE/CUTTING INSTR,2013,1302,835,467
ASSAULT,AGGRAVATED:KNIFE/CUTTING INSTR,2014,1229,779,450
ASSAULT,AGGRAVATED:KNIFE/CUTTING INSTR,2015,1214,773,441
ASSAULT,AGGRAVATED:KNIFE/CUTTING INSTR,2016,1337,936,401
ASSAULT,AGGRAVATED:KNIFE/CUTTING INSTR,2017,1464,1027,437
ASSAULT,AGGRAVATED:KNIFE/CUTTING INSTR,2018,1475,1079,396
ASSAULT,PRO EMP HANDS NO/MIN INJURY,2008,2562,1598,964
ASSAULT,PRO EMP HANDS NO/MIN INJURY,2009,2062,1174,888
ASSAULT,PRO EMP HANDS NO/MIN INJURY,2010,1912,1131,781
ASSAULT,PRO EMP HANDS NO/MIN INJURY,2011,849,480,369
ASSAULT,PRO EMP HANDS NO/MIN INJURY,2012,679,425,254
ASSAULT,PRO EMP HANDS NO/MIN INJURY,2013,704,419,285
ASSAULT,PRO EMP HANDS NO/MIN INJURY,2014,697,402,295
ASSAULT,PRO EMP HANDS NO/MIN INJURY,2015,569,349,220
ASSAULT,PRO EMP HANDS NO/MIN INJURY,2016,554,356,198
ASSAULT,PRO EMP HANDS NO/MIN INJURY,2017,523,369,154
ASSAULT,PRO EMP HANDS NO/MIN INJURY,2018,692,489,203
ASSAULT,SIMPLE,2008,34745,29438,5307
ASSAULT,SIMPLE,2009,30266,24612,5654
ASSAULT,SIMPLE,2010,28048,23129,4919
ASSAULT,SIMPLE,2011,13912,11293,2619
ASSAULT,SIMPLE,2012,13823,11330,2493
ASSAULT,SIMPLE,2013,12498,10106,2392
ASSAULT,SIMPLE,2014,11239,8881,2358
ASSAULT,SIMPLE,2015,11506,9406,2100
ASSAULT,SIMPLE,2016,11718,10022,1696
ASSAULT,SIMPLE,2017,12696,10964,1732
ASSAULT,SIMPLE,2018,12543,11046,1497
BATTERY,AGG PO HANDS ETC SERIOUS INJ,2008,104,10,94
BATTERY,AGG PO HANDS ETC SERIOUS INJ,2009,86,0,86
BATTERY,AGG PO HANDS ETC SERIOUS INJ,2010,70,12,58
BATTERY,AGG PO HANDS ETC SERIOUS INJ,2011,26,4,22
BATTERY,AGG PO HANDS ETC SERIOUS INJ,2012,3,2,1
BATTERY,AGG PO HANDS ETC SERIOUS INJ,2013,20,2,18
BATTERY,AGG PO HANDS ETC SERIOUS INJ,2014,19,0,19
BATTERY,AGG PO HANDS ETC SERIOUS INJ,2015,19,5,14
BATTERY,AGG PO HANDS ETC SERIOUS INJ,2016,19,4,15
BATTERY,AGG PO HANDS ETC SERIOUS INJ,2017,28,1,27
BATTERY,AGG PO HANDS ETC SERIOUS INJ,2018,19,3,16
BATTERY,AGG PO HANDS NO/MIN INJURY,2008,1656,256,1400
BATTERY,AGG PO HANDS NO/MIN INJURY,2009,1790,164,1626
BATTERY,AGG PO HANDS NO/MIN INJURY,2010,1649,175,1474
BATTERY,AGG PO HANDS NO/MIN INJURY,2011,809,49,760
BATTERY,AGG PO HANDS NO/MIN INJURY,2012,904,66,838
BATTERY,AGG PO HANDS NO/MIN INJURY,2013,775,58,717
BATTERY,AGG PO HANDS NO/MIN INJURY,2014,751,74,677
BATTERY,AGG PO HANDS NO/MIN INJURY,2015,711,54,657
BATTERY,AGG PO HANDS NO/MIN INJURY,2016,589,90,499
BATTERY,AGG PO HANDS NO/MIN INJURY,2017,528,65,463
BATTERY,AGG PO HANDS NO/MIN INJURY,2018,612,124,488
BATTERY,AGG PRO EMP HANDS SERIOUS INJ,2008,106,46,60
BATTERY,AGG PRO EMP HANDS SERIOUS INJ,2009,130,48,82
BATTERY,AGG PRO EMP HANDS SERIOUS INJ,2010,80,27,53
BATTERY,AGG PRO EMP HANDS SERIOUS INJ,2011,40,12,28
BATTERY,AGG PRO EMP HANDS SERIOUS INJ,2012,3,0,3
BATTERY,AGG PRO EMP HANDS SERIOUS INJ,2013,7,1,6
BATTERY,AGG PRO EMP HANDS SERIOUS INJ,2014,15,6,9
BATTERY,AGG PRO EMP HANDS SERIOUS INJ,2015,28,11,17
BATTERY,AGG PRO EMP HANDS SERIOUS INJ,2016,32,14,18
BATTERY,AGG PRO EMP HANDS SERIOUS INJ,2017,32,11,21
BATTERY,AGG PRO EMP HANDS SERIOUS INJ,2018,28,11,17
BATTERY,AGG PRO.EMP: HANDGUN,2008,22,14,8
BATTERY,AGG PRO.EMP: HANDGUN,2009,10,6,4
BATTERY,AGG PRO.EMP: HANDGUN,2010,4,0,4
BATTERY,AGG PRO.EMP: OTHER DANG WEAPON,2008,190,132,58
BATTERY,AGG PRO.EMP: OTHER DANG WEAPON,2009,192,130,62
BATTERY,AGG PRO.EMP: OTHER DANG WEAPON,2010,227,150,77
BATTERY,AGG PRO.EMP: OTHER DANG WEAPON,2011,87,58,29
BATTERY,AGG PRO.EMP: OTHER DANG WEAPON,2012,24,11,13
BATTERY,AGG PRO.EMP: OTHER DANG WEAPON,2013,21,12,9
BATTERY,AGG PRO.EMP: OTHER DANG WEAPON,2014,39,23,16
BATTERY,AGG PRO.EMP: OTHER DANG WEAPON,2015,71,47,24
BATTERY,AGG PRO.EMP: OTHER DANG WEAPON,2016,58,38,20
BATTERY,AGG PRO.EMP: OTHER DANG WEAPON,2017,55,42,13
BATTERY,AGG PRO.EMP: OTHER DANG WEAPON,2018,83,63,20
BATTERY,AGG PRO.EMP: OTHER FIREARM,2009,8,2,6
BATTERY,AGG PRO.EMP: OTHER FIREARM,2011,2,1,1
BATTERY,AGG PRO.EMP:KNIFE/CUTTING INST,2008,18,12,6
BATTERY,AGG PRO.EMP:KNIFE/CUTTING INST,2009,30,22,8
BATTERY,AGG PRO.EMP:KNIFE/CUTTING INST,2010,24,19,5
BATTERY,AGG PRO.EMP:KNIFE/CUTTING INST,2011,12,8,4
BATTERY,AGG PRO.EMP:KNIFE/CUTTING INST,2012,13,11,2
BATTERY,AGG PRO.EMP:KNIFE/CUTTING INST,2013,8,6,2
BATTERY,AGG PRO.EMP:KNIFE/CUTTING INST,2014,8,7,1
BATTERY,AGG PRO.EMP:KNIFE/CUTTING INST,2015,11,6,5
BATTERY,AGG PRO.EMP:KNIFE/CUTTING INST,2016,6,5,1
BATTERY,AGG PRO.EMP:KNIFE/CUTTING INST,2017,10,6,4
BATTERY,AGG PRO.EMP:KNIFE/CUTTING INST,2018,4,3,1
BATTERY,AGG: HANDS/FIST/FEET NO/MINOR INJURY,2008,488,386,102
BATTERY,AGG: HANDS/FIST/FEET NO/MINOR INJURY,2009,494,350,144
BATTERY,AGG: HANDS/FIST/FEET NO/MINOR INJURY,2010,450,328,122
BATTERY,AGG: HANDS/FIST/FEET NO/MINOR INJURY,2011,222,149,73
BATTERY,AGG: HANDS/FIST/FEET NO/MINOR INJURY,2012,166,103,63
BATTERY,AGG: HANDS/FIST/FEET NO/MINOR INJURY,2013,153,93,60
BATTERY,AGG: HANDS/FIST/FEET NO/MINOR INJURY,2014,135,84,51
BATTERY,AGG: HANDS/FIST/FEET NO/MINOR INJURY,2015,134,90,44
BATTERY,AGG: HANDS/FIST/FEET NO/MINOR INJURY,2016,131,88,43
BATTERY,AGG: HANDS/FIST/FEET NO/MINOR INJURY,2017,169,111,58
BATTERY,AGG: HANDS/FIST/FEET NO/MINOR INJURY,2018,194,137,57
BATTERY,AGG: HANDS/FIST/FEET SERIOUS INJURY,2008,300,236,64
BATTERY,AGG: HANDS/FIST/FEET SERIOUS INJURY,2009,344,266,78
BATTERY,AGG: HANDS/FIST/FEET SERIOUS INJURY,2010,362,287,75
BATTERY,AGG: HANDS/FIST/FEET SERIOUS INJURY,2011,204,160,44
BATTERY,AGG: HANDS/FIST/FEET SERIOUS INJURY,2012,180,144,36
BATTERY,AGG: HANDS/FIST/FEET SERIOUS INJURY,2013,146,111,35
BATTERY,AGG: HANDS/FIST/FEET SERIOUS INJURY,2014,162,124,38
BATTERY,AGG: HANDS/FIST/FEET SERIOUS INJURY,2015,160,134,26
BATTERY,AGG: HANDS/FIST/FEET SERIOUS INJURY,2016,152,128,24
BATTERY,AGG: HANDS/FIST/FEET SERIOUS INJURY,2017,137,108,29
BATTERY,AGG: HANDS/FIST/FEET SERIOUS INJURY,2018,155,123,32
BATTERY,AGGRAVATED DOMESTIC BATTERY: HANDGUN,2008,166,150,16
BATTERY,AGGRAVATED DOMESTIC BATTERY: HANDGUN,2009,46,18,28
BATTERY,AGGRAVATED DOMESTIC BATTERY: HANDGUN,2010,46,29,17
BATTERY,AGGRAVATED DOMESTIC BATTERY: HANDGUN,2011,13,3,10
BATTERY,AGGRAVATED DOMESTIC BATTERY: HANDGUN,2012,9,4,5
BATTERY,AGGRAVATED DOMESTIC BATTERY: HANDGUN,2013,7,0,7
BATTERY,AGGRAVATED DOMESTIC BATTERY: HANDGUN,2014,4,1,3
BATTERY,AGGRAVATED DOMESTIC BATTERY: HANDGUN,2015,13,3,10
BATTERY,AGGRAVATED DOMESTIC BATTERY: HANDGUN,2016,11,7,4
BATTERY,AGGRAVATED DOMESTIC BATTERY: HANDGUN,2017,12,3,9
BATTERY,AGGRAVATED DOMESTIC BATTERY: HANDGUN,2018,10,8,2
BATTERY,AGGRAVATED DOMESTIC BATTERY: HANDS/FIST/FEET SERIOUS INJURY,2008,390,248,142
BATTERY,AGGRAVATED DOMESTIC BATTERY: HANDS/FIST/FEET SERIOUS INJURY,2009,332,210,122
BATTERY,AGGRAVATED DOMESTIC BATTERY: HANDS/FIST/FEET SERIOUS INJURY,2010,464,303,161
BATTERY,AGGRAVATED DOMESTIC BATTERY: HANDS/FIST/FEET SERIOUS INJURY,2011,137,78,59
BATTERY,AGGRAVATED DOMESTIC BATTERY: HANDS/FIST/FEET SERIOUS INJURY,2012,153,100,53
BATTERY,AGGRAVATED DOMESTIC BATTERY: HANDS/FIST/FEET SERIOUS INJURY,2013,160,92,68
BATTERY,AGGRAVATED DOMESTIC BATTERY: HANDS/FIST/FEET SERIOUS INJURY,2014,138,74,64
BATTERY,AGGRAVATED DOMESTIC BATTERY: HANDS/FIST/FEET SERIOUS INJURY,2015,152,91,61
BATTERY,AGGRAVATED DOMESTIC BATTERY: HANDS/FIST/FEET SERIOUS INJURY,2016,245,147,98
BATTERY,AGGRAVATED DOMESTIC BATTERY: HANDS/FIST/FEET SERIOUS INJURY,2017,458,290,168
BATTERY,AGGRAVATED DOMESTIC BATTERY: HANDS/FIST/FEET SERIOUS INJURY,2018,545,365,180
BATTERY,AGGRAVATED DOMESTIC BATTERY: KNIFE/CUTTING INST,2008,1852,1222,630
BATTERY,AGGRAVATED DOMESTIC BATTERY: KNIFE/CUTTING INST,2009,1926,1214,712
BATTERY,AGGRAVATED DOMESTIC BATTERY: KNIFE/CUTTING INST,2010,1602,1032,570
BATTERY,AGGRAVATED DOMESTIC BATTERY: KNIFE/CUTTING INST,2011,820,507,313
BATTERY,AGGRAVATED DOMESTIC BATTERY: KNIFE/CUTTING INST,2012,817,529,288
BATTERY,AGGRAVATED DOMESTIC BATTERY: KNIFE/CUTTING INST,2013,745,444,301
BATTERY,AGGRAVATED DOMESTIC BATTERY: KNIFE/CUTTING INST,2014,669,412,257
BATTERY,AGGRAVATED DOMESTIC BATTERY: KNIFE/CUTTING INST,2015,685,418,267
BATTERY,AGGRAVATED DOMESTIC BATTERY: KNIFE/CUTTING INST,2016,704,476,228
BATTERY,AGGRAVATED DOMESTIC BATTERY: KNIFE/CUTTING INST,2017,717,488,229
BATTERY,AGGRAVATED DOMESTIC BATTERY: KNIFE/CUTTING INST,2018,731,502,229
BATTERY,AGGRAVATED DOMESTIC BATTERY: OTHER DANG WEAPON,2008,2902,2156,746
BATTERY,AGGRAVATED DOMESTIC BATTERY: OTHER DANG WEAPON,2009,2952,2148,804
BATTERY,AGGRAVATED DOMESTIC BATTERY: OTHER DANG WEAPON,2010,2489,1912,577
BATTERY,AGGRAVATED DOMESTIC BATTERY: OTHER DANG WEAPON,2011,1126,839,287
BATTERY,AGGRAVATED DOMESTIC BATTERY: OTHER DANG WEAPON,2012,1055,797,258
BATTERY,AGGRAVATED DOMESTIC BATTERY: OTHER DANG WEAPON,2013,968,699,269
BATTERY,AGGRAVATED DOMESTIC BATTERY: OTHER DANG WEAPON,2014,861,627,234
BATTERY,AGGRAVATED DOMESTIC BATTERY: OTHER DANG WEAPON,2015,1011,761,250
BATTERY,AGGRAVATED DOMESTIC BATTERY: OTHER DANG WEAPON,2016,1035,785,250
BATTERY,AGGRAVATED DOMESTIC BATTERY: OTHER DANG WEAPON,2017,1128,863,265
BATTERY,AGGRAVATED DOMESTIC BATTERY: OTHER DANG WEAPON,2018,1110,844,266
BATTERY,AGGRAVATED DOMESTIC BATTERY: OTHER FIREARM,2008,36,22,14
BATTERY,AGGRAVATED DOMESTIC BATTERY: OTHER FIREARM,2009,12,6,6
BATTERY,AGGRAVATED DOMESTIC BATTERY: OTHER FIREARM,2015,1,0,1
BATTERY,AGGRAVATED OF A CHILD,2008,50,28,22
BATTERY,AGGRAVATED OF A CHILD,2009,72,48,24
BATTERY,AGGRAVATED OF A CHILD,2010,65,41,24
BATTERY,AGGRAVATED OF A CHILD,2011,29,16,13
BATTERY,AGGRAVATED OF A CHILD,2012,21,13,8
BATTERY,AGGRAVATED OF A CHILD,2013,39,26,13
BATTERY,AGGRAVATED OF A CHILD,2014,23,12,11
BATTERY,AGGRAVATED OF A CHILD,2015,44,28,16
BATTERY,AGGRAVATED OF A CHILD,2016,50,31,19
BATTERY,AGGRAVATED OF A CHILD,2017,76,54,22
BATTERY,AGGRAVATED OF A CHILD,2018,57,39,18
BATTERY,AGGRAVATED OF A SENIOR CITIZEN,2008,252,162,90
BATTERY,AGGRAVATED OF A SENIOR CITIZEN,2009,258,188,70
BATTERY,AGGRAVATED OF A SENIOR CITIZEN,2010,221,155,66
BATTERY,AGGRAVATED OF A SENIOR CITIZEN,2011,154,98,56
BATTERY,AGGRAVATED OF A SENIOR CITIZEN,2012,149,92,57
BATTERY,AGGRAVATED OF A SENIOR CITIZEN,2013,133,80,53
BATTERY,AGGRAVATED OF A SENIOR CITIZEN,2014,85,52,33
BATTERY,AGGRAVATED OF A SENIOR CITIZEN,2015,142,101,41
BATTERY,AGGRAVATED OF A SENIOR CITIZEN,2016,159,117,42
BATTERY,AGGRAVATED OF A SENIOR CITIZEN,2017,237,170,67
BATTERY,AGGRAVATED OF A SENIOR CITIZEN,2018,209,159,50
BATTERY,AGGRAVATED OF A UNBORN CHILD,2008,4,2,2
BATTERY,AGGRAVATED OF A UNBORN CHILD,2009,6,4,2
BATTERY,AGGRAVATED OF A UNBORN CHILD,2010,6,4,2
BATTERY,AGGRAVATED OF A UNBORN CHILD,2013,3,1,2
BATTERY,AGGRAVATED OF A UNBORN CHILD,2017,5,4,1
BATTERY,AGGRAVATED PO: HANDGUN,2008,20,8,12
BATTERY,AGGRAVATED PO: HANDGUN,2009,8,0,8
BATTERY,AGGRAVATED PO: HANDGUN,2010,9,5,4
BATTERY,AGGRAVATED PO: HANDGUN,2011,4,1,3
BATTERY,AGGRAVATED PO: HANDGUN,2012,4,1,3
BATTERY,AGGRAVATED PO: HANDGUN,2014,2,0,2
BATTERY,AGGRAVATED PO: HANDGUN,2016,6,4,2
BATTERY,AGGRAVATED PO: HANDGUN,2017,3,1,2
BATTERY,AGGRAVATED PO: HANDGUN,2018,5,4,1
BATTERY,AGGRAVATED PO: KNIFE/CUT INSTR,2008,18,8,10
BATTERY,AGGRAVATED PO: KNIFE/CUT INSTR,2009,32,22,10
BATTERY,AGGRAVATED PO: KNIFE/CUT INSTR,2010,34,18,16
BATTERY,AGGRAVATED PO: KNIFE/CUT INSTR,2011,13,8,5
BATTERY,AGGRAVATED PO: KNIFE/CUT INSTR,2012,12,10,2
BATTERY,AGGRAVATED PO: KNIFE/CUT INSTR,2013,9,6,3
BATTERY,AGGRAVATED PO: KNIFE/CUT INSTR,2014,9,6,3
BATTERY,AGGRAVATED PO: KNIFE/CUT INSTR,2015,7,3,4
BATTERY,AGGRAVATED PO: KNIFE/CUT INSTR,2016,7,6,1
BATTERY,AGGRAVATED PO: KNIFE/CUT INSTR,2017,11,6,5
BATTERY,AGGRAVATED PO: KNIFE/CUT INSTR,2018,5,3,2
BATTERY,AGGRAVATED PO: OTHER DANG WEAP,2008,166,48,118
BATTERY,AGGRAVATED PO: OTHER DANG WEAP,2009,228,42,186
BATTERY,AGGRAVATED PO: OTHER DANG WEAP,2010,195,57,138
BATTERY,AGGRAVATED PO: OTHER DANG WEAP,2011,89,23,66
BATTERY,AGGRAVATED PO: OTHER DANG WEAP,2012,42,12,30
BATTERY,AGGRAVATED PO: OTHER DANG WEAP,2013,30,3,27
BATTERY,AGGRAVATED PO: OTHER DANG WEAP,2014,47,10,37
BATTERY,AGGRAVATED PO: OTHER DANG WEAP,2015,59,9,50
BATTERY,AGGRAVATED PO: OTHER DANG WEAP,2016,61,23,38
BATTERY,AGGRAVATED PO: OTHER DANG WEAP,2017,69,21,48
BATTERY,AGGRAVATED PO: OTHER DANG WEAP,2018,59,20,39
BATTERY,AGGRAVATED PO: OTHER FIREARM,2008,2,0,2
BATTERY,AGGRAVATED PO: OTHER FIREARM,2010,2,0,2
BATTERY,AGGRAVATED: HANDGUN,2008,3643,3364,279
BATTERY,AGGRAVATED: HANDGUN,2009,3434,3180,254
BATTERY,AGGRAVATED: HANDGUN,2010,3419,3188,231
BATTERY,AGGRAVATED: HANDGUN,2011,1696,1563,133
BATTERY,AGGRAVATED: HANDGUN,2012,1859,1745,114
BATTERY,AGGRAVATED: HANDGUN,2013,1388,1271,117
BATTERY,AGGRAVATED: HANDGUN,2014,1579,1467,112
BATTERY,AGGRAVATED: HANDGUN,2015,1878,1772,106
BATTERY,AGGRAVATED: HANDGUN,2016,2682,2612,70
BATTERY,AGGRAVATED: HANDGUN,2017,2038,1941,97
BATTERY,AGGRAVATED: HANDGUN,2018,1690,1616,74
BATTERY,AGGRAVATED: OTHER DANG WEAPON,2008,8214,6914,1300
BATTERY,AGGRAVATED: OTHER DANG WEAPON,2009,7310,6156,1154
BATTERY,AGGRAVATED: OTHER DANG WEAPON,2010,6217,5163,1054
BATTERY,AGGRAVATED: OTHER DANG WEAPON,2011,2776,2275,501
BATTERY,AGGRAVATED: OTHER DANG WEAPON,2012,2415,2021,394
BATTERY,AGGRAVATED: OTHER DANG WEAPON,2013,1941,1583,358
BATTERY,AGGRAVATED: OTHER DANG WEAPON,2014,1928,1564,364
BATTERY,AGGRAVATED: OTHER DANG WEAPON,2015,1826,1531,295
BATTERY,AGGRAVATED: OTHER DANG WEAPON,2016,1802,1541,261
BATTERY,AGGRAVATED: OTHER DANG WEAPON,2017,1871,1597,274
BATTERY,AGGRAVATED: OTHER DANG WEAPON,2018,1741,1485,256
BATTERY,AGGRAVATED: OTHER FIREARM,2008,74,66,8
BATTERY,AGGRAVATED: OTHER FIREARM,2009,66,60,6
BATTERY,AGGRAVATED: OTHER FIREARM,2010,79,73,6
BATTERY,AGGRAVATED: OTHER FIREARM,2011,21,17,4
BATTERY,AGGRAVATED: OTHER FIREARM,2018,14,13,1
BATTERY,AGGRAVATED:KNIFE/CUTTING INSTR,2008,2980,2408,572
BATTERY,AGGRAVATED:KNIFE/CUTTING INSTR,2009,2598,2072,526
BATTERY,AGGRAVATED:KNIFE/CUTTING INSTR,2010,2405,1886,519
BATTERY,AGGRAVATED:KNIFE/CUTTING INSTR,2011,1148,904,244
BATTERY,AGGRAVATED:KNIFE/CUTTING INSTR,2012,1230,961,269
BATTERY,AGGRAVATED:KNIFE/CUTTING INSTR,2013,977,769,208
BATTERY,AGGRAVATED:KNIFE/CUTTING INSTR,2014,868,672,196
BATTERY,AGGRAVATED:KNIFE/CUTTING INSTR,2015,855,667,188
BATTERY,AGGRAVATED:KNIFE/CUTTING INSTR,2016,839,676,163
BATTERY,AGGRAVATED:KNIFE/CUTTING INSTR,2017,921,751,170
BATTERY,AGGRAVATED:KNIFE/CUTTING INSTR,2018,861,720,141
BATTERY,DOMESTIC BATTERY SIMPLE,2008,71918,57248,14670
BATTERY,DOMESTIC BATTERY SIMPLE,2009,65292,49804,15488
BATTERY,DOMESTIC BATTERY SIMPLE,2010,59585,46851,12734
BATTERY,DOMESTIC BATTERY SIMPLE,2011,29680,22982,6698
BATTERY,DOMESTIC BATTERY SIMPLE,2012,28740,22684,6056
BATTERY,DOMESTIC BATTERY SIMPLE,2013,26925,20683,6242
BATTERY,DOMESTIC BATTERY SIMPLE,2014,24221,18057,6164
BATTERY,DOMESTIC BATTERY SIMPLE,2015,24447,18605,5842
BATTERY,DOMESTIC BATTERY SIMPLE,2016,23952,18904,5048
BATTERY,DOMESTIC BATTERY SIMPLE,2017,23792,18902,4890
BATTERY,DOMESTIC BATTERY SIMPLE,2018,22645,17953,4692
BATTERY,OF UNBORN CHILD,2008,6,4,2
BATTERY,OF UNBORN CHILD,2009,8,2,6
BATTERY,OF UNBORN CHILD,2010,6,4,2
BATTERY,OF UNBORN CHILD,2011,3,2,1
BATTERY,OF UNBORN CHILD,2012,7,5,2
BATTERY,OF UNBORN CHILD,2014,5,2,3
BATTERY,OF UNBORN CHILD,2015,9,6,3
BATTERY,OF UNBORN CHILD,2018,5,4,1
BATTERY,PRO EMP HANDS NO/MIN INJURY,2008,2222,1198,1024
BATTERY,PRO EMP HANDS NO/MIN INJURY,2009,2021,986,1035
BATTERY,PRO EMP HANDS NO/MIN INJURY,2010,1921,985,936
BATTERY,PRO EMP HANDS NO/MIN INJURY,2011,898,462,436
BATTERY,PRO EMP HANDS NO/MIN INJURY,2012,755,374,381
BATTERY,PRO EMP HANDS NO/MIN INJURY,2013,821,442,379
BATTERY,PRO EMP HANDS NO/MIN INJURY,2014,786,394,392
BATTERY,PRO EMP HANDS NO/MIN INJURY,2015,703,398,305
BATTERY,PRO EMP HANDS NO/MIN INJURY,2016,647,367,280
BATTERY,PRO EMP HANDS NO/MIN INJURY,2017,666,394,272
BATTERY,PRO EMP HANDS NO/MIN INJURY,2018,779,471,308
BATTERY,SIMPLE,2008,53111,43726,9385
BATTERY,SIMPLE,2009,45846,35952,9894
BATTERY,SIMPLE,2010,42769,34513,8256
BATTERY,SIMPLE,2011,20504,16143,4361
BATTERY,SIMPLE,2012,20540,16360,4180
BATTERY,SIMPLE,2013,18576,14558,4018
BATTERY,SIMPLE,2014,16317,12545,3772
BATTERY,SIMPLE,2015,15597,12307,3290
BATTERY,SIMPLE,2016,15481,12548,2933
BATTERY,SIMPLE,2017,16141,13219,2922
BATTERY,SIMPLE,2018,15157,12697,2460
BURGLARY,ATTEMPT FORCIBLE ENTRY,2008,2092,1868,224
BURGLARY,ATTEMPT FORCIBLE ENTRY,2009,2038,1818,220
BURGLARY,ATTEMPT FORCIBLE ENTRY,2010,2336,2115,221
BURGLARY,ATTEMPT FORCIBLE ENTRY,2011,1597,1483,114
BURGLARY,ATTEMPT FORCIBLE ENTRY,2012,1126,1021,105
BURGLARY,ATTEMPT FORCIBLE ENTRY,2013,764,684,80
BURGLARY,ATTEMPT FORCIBLE ENTRY,2014,565,496,69
BURGLARY,ATTEMPT FORCIBLE ENTRY,2015,513,460,53
BURGLARY,ATTEMPT FORCIBLE ENTRY,2016,667,627,40
BURGLARY,ATTEMPT FORCIBLE ENTRY,2017,635,604,31
BURGLARY,ATTEMPT FORCIBLE ENTRY,2018,492,469,23
BURGLARY,FORCIBLE ENTRY,2008,35782,33715,2067
BURGLARY,FORCIBLE ENTRY,2009,36778,34896,1882
BURGLARY,FORCIBLE ENTRY,2010,33416,31727,1689
BURGLARY,FORCIBLE ENTRY,2011,17699,16925,774
BURGLARY,FORCIBLE ENTRY,2012,15089,14255,834
BURGLARY,FORCIBLE ENTRY,2013,11748,11065,683
BURGLARY,FORCIBLE ENTRY,2014,9154,8643,511
BURGLARY,FORCIBLE ENTRY,2015,8209,7859,350
BURGLARY,FORCIBLE ENTRY,2016,8281,8002,279
BURGLARY,FORCIBLE ENTRY,2017,7479,7162,317
BURGLARY,FORCIBLE ENTRY,2018,6149,5918,231
BURGLARY,HOME INVASION,2008,784,672,112
BURGLARY,HOME INVASION,2009,762,686,76
BURGLARY,HOME INVASION,2010,520,454,66
BURGLARY,HOME INVASION,2011,338,298,40
BURGLARY,HOME INVASION,2012,298,264,34
BURGLARY,HOME INVASION,2013,231,190,41
BURGLARY,HOME INVASION,2014,197,174,23
BURGLARY,HOME INVASION,2015,238,196,42
BURGLARY,HOME INVASION,2016,253,220,33
BURGLARY,HOME INVASION,2017,266,232,34
BURGLARY,HOME INVASION,2018,271,244,27
BURGLARY,UNLAWFUL ENTRY,2008,13364,12674,690
BURGLARY,UNLAWFUL ENTRY,2009,13407,12782,625
BURGLARY,UNLAWFUL ENTRY,2010,13228,12554,674
BURGLARY,UNLAWFUL ENTRY,2011,6982,6647,335
BURGLARY,UNLAWFUL ENTRY,2012,6324,6020,304
BURGLARY,UNLAWFUL ENTRY,2013,5082,4796,286
BURGLARY,UNLAWFUL ENTRY,2014,4396,4130,266
BURGLARY,UNLAWFUL ENTRY,2015,4126,3900,226
BURGLARY,UNLAWFUL ENTRY,2016,4412,4242,170
BURGLARY,UNLAWFUL ENTRY,2017,4567,4342,225
BURGLARY,UNLAWFUL ENTRY,2018,4026,3853,173
CONCEALED CARRY LICENSE VIOLATION,ARMED WHILE UNDER THE INFLUENCE,2014,5,3,2
CONCEALED CARRY LICENSE VIOLATION,ARMED WHILE UNDER THE INFLUENCE,2015,15,0,15
CONCEALED CARRY LICENSE VIOLATION,ARMED WHILE UNDER THE INFLUENCE,2016,8,0,8
CONCEALED CARRY LICENSE VIOLATION,ARMED WHILE UNDER THE INFLUENCE,2017,16,0,16
CONCEALED CARRY LICENSE VIOLATION,ARMED WHILE UNDER THE INFLUENCE,2018,46,0,46
CONCEALED CARRY LICENSE VIOLATION,OTHER,2014,9,5,4
CONCEALED CARRY LICENSE VIOLATION,OTHER,2015,10,1,9
CONCEALED CARRY LICENSE VIOLATION,OTHER,2016,8,0,8
CONCEALED CARRY LICENSE VIOLATION,OTHER,2017,16,0,16
CONCEALED CARRY LICENSE VIOLATION,OTHER,2018,43,1,42
CONCEALED CARRY LICENSE VIOLATION,PROHIBITED PLACES,2015,9,0,9
CONCEALED CARRY LICENSE VIOLATION,PROHIBITED PLACES,2016,19,2,17
CONCEALED CARRY LICENSE VIOLATION,PROHIBITED PLACES,2017,37,3,34
CONCEALED CARRY LICENSE VIOLATION,PROHIBITED PLACES,2018,49,3,46
CRIM SEXUAL ASSAULT,AGGRAVATED: HANDGUN,2008,170,148,22
CRIM SEXUAL ASSAULT,AGGRAVATED: HANDGUN,2009,184,144,40
CRIM SEXUAL ASSAULT,AGGRAVATED: HANDGUN,2010,153,127,26
CRIM SEXUAL ASSAULT,AGGRAVATED: HANDGUN,2011,111,97,14
CRIM SEXUAL ASSAULT,AGGRAVATED: HANDGUN,2012,90,80,10
CRIM SEXUAL ASSAULT,AGGRAVATED: HANDGUN,2013,60,46,14
CRIM SEXUAL ASSAULT,AGGRAVATED: HANDGUN,2014,67,58,9
CRIM SEXUAL ASSAULT,AGGRAVATED: HANDGUN,2015,55,51,4
CRIM SEXUAL ASSAULT,AGGRAVATED: HANDGUN,2016,64,62,2
CRIM SEXUAL ASSAULT,AGGRAVATED: HANDGUN,2017,68,63,5
CRIM SEXUAL ASSAULT,AGGRAVATED: HANDGUN,2018,52,48,4
CRIM SEXUAL ASSAULT,AGGRAVATED: KNIFE/CUT INSTR,2008,138,96,42
CRIM SEXUAL ASSAULT,AGGRAVATED: KNIFE/CUT INSTR,2009,112,84,28
CRIM SEXUAL ASSAULT,AGGRAVATED: KNIFE/CUT INSTR,2010,97,76,21
CRIM SEXUAL ASSAULT,AGGRAVATED: KNIFE/CUT INSTR,2011,46,37,9
CRIM SEXUAL ASSAULT,AGGRAVATED: KNIFE/CUT INSTR,2012,51,41,10
CRIM SEXUAL ASSAULT,AGGRAVATED: KNIFE/CUT INSTR,2013,42,31,11
CRIM SEXUAL ASSAULT,AGGRAVATED: KNIFE/CUT INSTR,2014,58,50,8
CRIM SEXUAL ASSAULT,AGGRAVATED: KNIFE/CUT INSTR,2015,35,31,4
CRIM SEXUAL ASSAULT,AGGRAVATED: KNIFE/CUT INSTR,2016,22,19,3
CRIM SEXUAL ASSAULT,AGGRAVATED: KNIFE/CUT INSTR,2017,36,32,4
CRIM SEXUAL ASSAULT,AGGRAVATED: KNIFE/CUT INSTR,2018,31,30,1
CRIM SEXUAL ASSAULT,AGGRAVATED: OTHER,2008,492,368,124
CRIM SEXUAL ASSAULT,AGGRAVATED: OTHER,2009,459,365,94
CRIM SEXUAL ASSAULT,AGGRAVATED: OTHER,2010,371,276,95
CRIM SEXUAL ASSAULT,AGGRAVATED: OTHER,2011,215,173,42
CRIM SEXUAL ASSAULT,AGGRAVATED: OTHER,2012,207,171,36
CRIM SEXUAL ASSAULT,AGGRAVATED: OTHER,2013,182,142,40
CRIM SEXUAL ASSAULT,AGGRAVATED: OTHER,2014,166,143,23
CRIM SEXUAL ASSAULT,AGGRAVATED: OTHER,2015,172,143,29
CRIM SEXUAL ASSAULT,AGGRAVATED: OTHER,2016,180,163,17
CRIM SEXUAL ASSAULT,AGGRAVATED: OTHER,2017,184,169,15
CRIM SEXUAL ASSAULT,AGGRAVATED: OTHER,2018,202,184,18
CRIM SEXUAL ASSAULT,AGGRAVATED: OTHER DANG WEAPON,2008,34,30,4
CRIM SEXUAL ASSAULT,AGGRAVATED: OTHER DANG WEAPON,2009,18,16,2
CRIM SEXUAL ASSAULT,AGGRAVATED: OTHER DANG WEAPON,2010,24,16,8
CRIM SEXUAL ASSAULT,AGGRAVATED: OTHER DANG WEAPON,2011,11,8,3
CRIM SEXUAL ASSAULT,AGGRAVATED: OTHER DANG WEAPON,2012,17,11,6
CRIM SEXUAL ASSAULT,AGGRAVATED: OTHER DANG WEAPON,2013,2,1,1
CRIM SEXUAL ASSAULT,AGGRAVATED: OTHER DANG WEAPON,2014,16,14,2
CRIM SEXUAL ASSAULT,AGGRAVATED: OTHER DANG WEAPON,2015,10,9,1
CRIM SEXUAL ASSAULT,AGGRAVATED: OTHER DANG WEAPON,2016,14,11,3
CRIM SEXUAL ASSAULT,AGGRAVATED: OTHER DANG WEAPON,2017,19,18,1
CRIM SEXUAL ASSAULT,AGGRAVATED: OTHER FIREARM,2009,2,0,2
CRIM SEXUAL ASSAULT,AGGRAVATED: OTHER FIREARM,2013,2,1,1
CRIM SEXUAL ASSAULT,AGGRAVATED: OTHER FIREARM,2015,3,1,2
CRIM SEXUAL ASSAULT,ATTEMPT AGG: HANDGUN,2008,18,14,4
CRIM SEXUAL ASSAULT,ATTEMPT AGG: HANDGUN,2009,14,10,4
CRIM SEXUAL ASSAULT,ATTEMPT AGG: HANDGUN,2010,12,8,4
CRIM SEXUAL ASSAULT,ATTEMPT AGG: HANDGUN,2012,11,7,4
CRIM SEXUAL ASSAULT,ATTEMPT AGG: HANDGUN,2013,7,6,1
CRIM SEXUAL ASSAULT,ATTEMPT AGG: HANDGUN,2014,5,3,2
CRIM SEXUAL ASSAULT,ATTEMPT AGG: HANDGUN,2015,5,4,1
CRIM SEXUAL ASSAULT,ATTEMPT AGG: HANDGUN,2017,5,4,1
CRIM SEXUAL ASSAULT,ATTEMPT AGG: HANDGUN,2018,6,5,1
CRIM SEXUAL ASSAULT,ATTEMPT AGG: KNIFE/CUT INSTR,2008,16,12,4
CRIM SEXUAL ASSAULT,ATTEMPT AGG: KNIFE/CUT INSTR,2009,14,10,4
CRIM SEXUAL ASSAULT,ATTEMPT AGG: KNIFE/CUT INSTR,2010,20,16,4
CRIM SEXUAL ASSAULT,ATTEMPT AGG: KNIFE/CUT INSTR,2012,8,6,2
CRIM SEXUAL ASSAULT,ATTEMPT AGG: KNIFE/CUT INSTR,2013,12,10,2
CRIM SEXUAL ASSAULT,ATTEMPT AGG: KNIFE/CUT INSTR,2014,2,1,1
CRIM SEXUAL ASSAULT,ATTEMPT AGG: OTHER,2008,20,12,8
CRIM SEXUAL ASSAULT,ATTEMPT AGG: OTHER,2009,26,22,4
CRIM SEXUAL ASSAULT,ATTEMPT AGG: OTHER,2010,30,18,12
CRIM SEXUAL ASSAULT,ATTEMPT AGG: OTHER,2011,16,12,4
CRIM SEXUAL ASSAULT,ATTEMPT AGG: OTHER,2012,9,8,1
CRIM SEXUAL ASSAULT,ATTEMPT AGG: OTHER,2013,14,9,5
CRIM SEXUAL ASSAULT,ATTEMPT AGG: OTHER,2014,12,9,3
CRIM SEXUAL ASSAULT,ATTEMPT AGG: OTHER,2015,12,11,1
CRIM SEXUAL ASSAULT,ATTEMPT AGG: OTHER,2016,9,5,4
CRIM SEXUAL ASSAULT,ATTEMPT AGG: OTHER,2017,11,8,3
CRIM SEXUAL ASSAULT,ATTEMPT AGG: OTHER,2018,10,8,2
CRIM SEXUAL ASSAULT,ATTEMPT AGG: OTHER DANG WEAPON,2008,8,6,2
CRIM SEXUAL ASSAULT,ATTEMPT AGG: OTHER DANG WEAPON,2011,3,1,2
CRIM SEXUAL ASSAULT,ATTEMPT AGG: OTHER DANG WEAPON,2016,1,0,1
CRIM SEXUAL ASSAULT,ATTEMPT NON-AGGRAVATED,2008,114,82,32
CRIM SEXUAL ASSAULT,ATTEMPT NON-AGGRAVATED,2009,98,84,14
CRIM SEXUAL ASSAULT,ATTEMPT NON-AGGRAVATED,2010,91,73,18
CRIM SEXUAL ASSAULT,ATTEMPT NON-AGGRAVATED,2011,65,47,18
CRIM SEXUAL ASSAULT,ATTEMPT NON-AGGRAVATED,2012,75,60,15
CRIM SEXUAL ASSAULT,ATTEMPT NON-AGGRAVATED,2013,65,56,9
CRIM SEXUAL ASSAULT,ATTEMPT NON-AGGRAVATED,2014,62,51,11
CRIM SEXUAL ASSAULT,ATTEMPT NON-AGGRAVATED,2015,71,64,7
CRIM SEXUAL ASSAULT,ATTEMPT NON-AGGRAVATED,2016,57,51,6
CRIM SEXUAL ASSAULT,ATTEMPT NON-AGGRAVATED,2017,66,59,7
CRIM SEXUAL ASSAULT,ATTEMPT NON-AGGRAVATED,2018,81,71,10
CRIM SEXUAL ASSAULT,NON-AGGRAVATED,2008,1599,1432,167
CRIM SEXUAL ASSAULT,NON-AGGRAVATED,2009,1456,1322,134
CRIM SEXUAL ASSAULT,NON-AGGRAVATED,2010,1396,1273,123
CRIM SEXUAL ASSAULT,NON-AGGRAVATED,2011,828,744,84
CRIM SEXUAL ASSAULT,NON-AGGRAVATED,2012,775,699,76
CRIM SEXUAL ASSAULT,NON-AGGRAVATED,2013,700,616,84
CRIM SEXUAL ASSAULT,NON-AGGRAVATED,2014,724,653,71
CRIM SEXUAL ASSAULT,NON-AGGRAVATED,2015,813,756,57
CRIM SEXUAL ASSAULT,NON-AGGRAVATED,2016,833,797,36
CRIM SEXUAL ASSAULT,NON-AGGRAVATED,2017,1062,1022,40
CRIM SEXUAL ASSAULT,NON-AGGRAVATED,2018,981,949,32
CRIM SEXUAL ASSAULT,PREDATORY,2008,208,142,66
CRIM SEXUAL ASSAULT,PREDATORY,2009,211,147,64
CRIM SEXUAL ASSAULT,PREDATORY,2010,189,108,81
CRIM SEXUAL ASSAULT,PREDATORY,2011,117,83,34
CRIM SEXUAL ASSAULT,PREDATORY,2012,105,74,31
CRIM SEXUAL ASSAULT,PREDATORY,2013,79,57,22
CRIM SEXUAL ASSAULT,PREDATORY,2014,100,67,33
CRIM SEXUAL ASSAULT,PREDATORY,2015,122,93,29
CRIM SEXUAL ASSAULT,PREDATORY,2016,80,69,11
CRIM SEXUAL ASSAULT,PREDATORY,2017,90,72,18
CRIM SEXUAL ASSAULT,PREDATORY,2018,98,90,8
CRIMINAL DAMAGE,CRIMINAL DEFACEMENT,2008,6134,5120,1014
CRIMINAL DAMAGE,CRIMINAL DEFACEMENT,2009,6844,5624,1220
CRIMINAL DAMAGE,CRIMINAL DEFACEMENT,2010,4767,3887,880
CRIMINAL DAMAGE,CRIMINAL DEFACEMENT,2011,2237,1820,417
CRIMINAL DAMAGE,CRIMINAL DEFACEMENT,2012,1845,1444,401
CRIMINAL DAMAGE,CRIMINAL DEFACEMENT,2013,1910,1557,353
CRIMINAL DAMAGE,CRIMINAL DEFACEMENT,2014,1491,1160,331
CRIMINAL DAMAGE,CRIMINAL DEFACEMENT,2015,1011,862,149
CRIMINAL DAMAGE,CRIMINAL DEFACEMENT,2016,885,761,124
CRIMINAL DAMAGE,CRIMINAL DEFACEMENT,2017,911,803,108
CRIMINAL DAMAGE,CRIMINAL DEFACEMENT,2018,818,714,104
CRIMINAL DAMAGE,INSTITUTIONAL VANDALISM,2008,174,148,26
CRIMINAL DAMAGE,INSTITUTIONAL VANDALISM,2009,170,154,16
CRIMINAL DAMAGE,INSTITUTIONAL VANDALISM,2010,116,102,14
CRIMINAL DAMAGE,INSTITUTIONAL VANDALISM,2011,27,18,9
CRIMINAL DAMAGE,INSTITUTIONAL VANDALISM,2012,34,29,5
CRIMINAL DAMAGE,INSTITUTIONAL VANDALISM,2013,18,14,4
CRIMINAL DAMAGE,INSTITUTIONAL VANDALISM,2014,13,10,3
CRIMINAL DAMAGE,INSTITUTIONAL VANDALISM,2015,18,17,1
CRIMINAL DAMAGE,INSTITUTIONAL VANDALISM,2017,20,18,2
CRIMINAL DAMAGE,LIBRARY VANDALISM,2008,10,8,2
CRIMINAL DAMAGE,LIBRARY VANDALISM,2010,17,9,8
CRIMINAL DAMAGE,LIBRARY VANDALISM,2017,6,4,2
CRIMINAL DAMAGE,TO CITY OF CHICAGO PROPERTY,2008,1750,1406,344
CRIMINAL DAMAGE,TO CITY OF CHICAGO PROPERTY,2009,1698,1352,346
CRIMINAL DAMAGE,TO CITY OF CHICAGO PROPERTY,2010,1653,1276,377
CRIMINAL DAMAGE,TO CITY OF CHICAGO PROPERTY,2011,751,564,187
CRIMINAL DAMAGE,TO CITY OF CHICAGO PROPERTY,2012,739,559,180
CRIMINAL DAMAGE,TO CITY OF CHICAGO PROPERTY,2013,643,483,160
CRIMINAL DAMAGE,TO CITY OF CHICAGO PROPERTY,2014,534,384,150
CRIMINAL DAMAGE,TO CITY OF CHICAGO PROPERTY,2015,540,419,121
CRIMINAL DAMAGE,TO CITY OF CHICAGO PROPERTY,2016,521,417,104
CRIMINAL DAMAGE,TO CITY OF CHICAGO PROPERTY,2017,562,439,123
CRIMINAL DAMAGE,TO CITY OF CHICAGO PROPERTY,2018,486,374,112
CRIMINAL DAMAGE,TO FIRE FIGHT.APP.EQUIP,2008,46,22,24
CRIMINAL DAMAGE,TO FIRE FIGHT.APP.EQUIP,2009,44,26,18
CRIMINAL DAMAGE,TO FIRE FIGHT.APP.EQUIP,2010,28,10,18
CRIMINAL DAMAGE,TO FIRE FIGHT.APP.EQUIP,2011,24,6,18
CRIMINAL DAMAGE,TO FIRE FIGHT.APP.EQUIP,2012,21,9,12
CRIMINAL DAMAGE,TO FIRE FIGHT.APP.EQUIP,2013,12,7,5
CRIMINAL DAMAGE,TO FIRE FIGHT.APP.EQUIP,2015,7,6,1
CRIMINAL DAMAGE,TO FIRE FIGHT.APP.EQUIP,2016,4,3,1
CRIMINAL DAMAGE,TO PROPERTY,2008,46174,42940,3234
CRIMINAL DAMAGE,TO PROPERTY,2009,41712,38718,2994
CRIMINAL DAMAGE,TO PROPERTY,2010,34269,32010,2259
CRIMINAL DAMAGE,TO PROPERTY,2011,17077,15873,1204
CRIMINAL DAMAGE,TO PROPERTY,2012,16500,15300,1200
CRIMINAL DAMAGE,TO PROPERTY,2013,14211,13176,1035
CRIMINAL DAMAGE,TO PROPERTY,2014,12690,11620,1070
CRIMINAL DAMAGE,TO PROPERTY,2015,13221,12194,1027
CRIMINAL DAMAGE,TO PROPERTY,2016,13721,12801,920
CRIMINAL DAMAGE,TO PROPERTY,2017,13802,12787,1015
CRIMINAL DAMAGE,TO PROPERTY,2018,12232,11330,902
CRIMINAL DAMAGE,TO STATE SUP PROP,2008,624,506,118
CRIMINAL DAMAGE,TO STATE SUP PROP,2009,520,434,86
CRIMINAL DAMAGE,TO STATE SUP PROP,2010,470,365,105
CRIMINAL DAMAGE,TO STATE SUP PROP,2011,207,165,42
CRIMINAL DAMAGE,TO STATE SUP PROP,2012,207,168,39
CRIMINAL DAMAGE,TO STATE SUP PROP,2013,179,136,43
CRIMINAL DAMAGE,TO STATE SUP PROP,2014,172,131,41
CRIMINAL DAMAGE,TO STATE SUP PROP,2015,154,125,29
CRIMINAL DAMAGE,TO STATE SUP PROP,2016,118,91,27
CRIMINAL DAMAGE,TO STATE SUP PROP,2017,139,110,29
CRIMINAL DAMAGE,TO STATE SUP PROP,2018,121,78,43
CRIMINAL DAMAGE,TO VEHICLE,2008,49490,47490,2000
CRIMINAL DAMAGE,TO VEHICLE,2009,43508,41686,1822
CRIMINAL DAMAGE,TO VEHICLE,2010,36130,34715,1415
CRIMINAL DAMAGE,TO VEHICLE,2011,16998,16292,706
CRIMINAL DAMAGE,TO VEHICLE,2012,16504,15879,625
CRIMINAL DAMAGE,TO VEHICLE,2013,13811,13308,503
CRIMINAL DAMAGE,TO VEHICLE,2014,12560,12087,473
CRIMINAL DAMAGE,TO VEHICLE,2015,13572,13073,499
CRIMINAL DAMAGE,TO VEHICLE,2016,14917,14476,441
CRIMINAL DAMAGE,TO VEHICLE,2017,13511,13043,468
CRIMINAL DAMAGE,TO VEHICLE,2018,12254,11847,407
CRIMINAL TRESPASS,TO AIRPORT,2008,46,14,32
CRIMINAL TRESPASS,TO AIRPORT,2009,38,0,38
CRIMINAL TRESPASS,TO AIRPORT,2010,43,4,39
CRIMINAL TRESPASS,TO AIRPORT,2011,17,0,17
CRIMINAL TRESPASS,TO AIRPORT,2012,8,0,8
CRIMINAL TRESPASS,TO AIRPORT,2013,9,1,8
CRIMINAL TRESPASS,TO AIRPORT,2014,8,0,8
CRIMINAL TRESPASS,TO AIRPORT,2015,16,3,13
CRIMINAL TRESPASS,TO AIRPORT,2016,7,0,7
CRIMINAL TRESPASS,TO AIRPORT,2017,5,0,5
CRIMINAL TRESPASS,TO AIRPORT,2018,16,1,15
CRIMINAL TRESPASS,TO LAND,2008,14468,5678,8790
CRIMINAL TRESPASS,TO LAND,2009,14084,2804,11280
CRIMINAL TRESPASS,TO LAND,2010,11677,2673,9004
CRIMINAL TRESPASS,TO LAND,2011,5862,1052,4810
CRIMINAL TRESPASS,TO LAND,2012,5372,928,4444
CRIMINAL TRESPASS,TO LAND,2013,5326,883,4443
CRIMINAL TRESPASS,TO LAND,2014,4727,805,3922
CRIMINAL TRESPASS,TO LAND,2015,3764,758,3006
CRIMINAL TRESPASS,TO LAND,2016,3442,856,2586
CRIMINAL TRESPASS,TO LAND,2017,3846,1035,2811
CRIMINAL TRESPASS,TO LAND,2018,3834,1225,2609
CRIMINAL TRESPASS,TO RESIDENCE,2008,3634,2448,1186
CRIMINAL TRESPASS,TO RESIDENCE,2009,3322,1958,1364
CRIMINAL TRESPASS,TO RESIDENCE,2010,2714,1738,976
CRIMINAL TRESPASS,TO RESIDENCE,2011,1353,831,522
CRIMINAL TRESPASS,TO RESIDENCE,2012,1320,834,486
CRIMINAL TRESPASS,TO RESIDENCE,2013,1279,776,503
CRIMINAL TRESPASS,TO RESIDENCE,2014,1258,774,484
CRIMINAL TRESPASS,TO RESIDENCE,2015,1190,739,451
CRIMINAL TRESPASS,TO RESIDENCE,2016,1272,899,373
CRIMINAL TRESPASS,TO RESIDENCE,2017,1378,951,427
CRIMINAL TRESPASS,TO RESIDENCE,2018,1288,957,331
CRIMINAL TRESPASS,TO STATE SUP LAND,2008,4994,2598,2396
CRIMINAL TRESPASS,TO STATE SUP LAND,2009,2992,512,2480
CRIMINAL TRESPASS,TO STATE SUP LAND,2010,2440,556,1884
CRIMINAL TRESPASS,TO STATE SUP LAND,2011,961,174,787
CRIMINAL TRESPASS,TO STATE SUP LAND,2012,946,140,806
CRIMINAL TRESPASS,TO STATE SUP LAND,2013,1008,147,861
CRIMINAL TRESPASS,TO STATE SUP LAND,2014,922,136,786
CRIMINAL TRESPASS,TO STATE SUP LAND,2015,771,95,676
CRIMINAL TRESPASS,TO STATE SUP LAND,2016,577,69,508
CRIMINAL TRESPASS,TO STATE SUP LAND,2017,587,69,518
CRIMINAL TRESPASS,TO STATE SUP LAND,2018,494,80,414
CRIMINAL TRESPASS,TO VEHICLE,2008,1300,724,576
CRIMINAL TRESPASS,TO VEHICLE,2009,1058,492,566
CRIMINAL TRESPASS,TO VEHICLE,2010,1039,562,477
CRIMINAL TRESPASS,TO VEHICLE,2011,464,185,279
CRIMINAL TRESPASS,TO VEHICLE,2012,569,258,311
CRIMINAL TRESPASS,TO VEHICLE,2013,508,250,258
CRIMINAL TRESPASS,TO VEHICLE,2014,580,296,284
CRIMINAL TRESPASS,TO VEHICLE,2015,642,397,245
CRIMINAL TRESPASS,TO VEHICLE,2016,911,671,240
CRIMINAL TRESPASS,TO VEHICLE,2017,983,727,256
CRIMINAL TRESPASS,TO VEHICLE,2018,822,635,187
DECEPTIVE PRACTICE,AGGRAVATED FINANCIAL IDENTITY THEFT,2013,6,3,3
DECEPTIVE PRACTICE,AGGRAVATED FINANCIAL IDENTITY THEFT,2014,76,74,2
DECEPTIVE PRACTICE,AGGRAVATED FINANCIAL IDENTITY THEFT,2015,131,124,7
DECEPTIVE PRACTICE,AGGRAVATED FINANCIAL IDENTITY THEFT,2016,70,67,3
DECEPTIVE PRACTICE,AGGRAVATED FINANCIAL IDENTITY THEFT,2017,132,131,1
DECEPTIVE PRACTICE,AGGRAVATED FINANCIAL IDENTITY THEFT,2018,80,79,1
DECEPTIVE PRACTICE,ALTER COINS,2017,2,1,1
DECEPTIVE PRACTICE,ATTEMPT - FINANCIAL IDENTITY THEFT,2014,381,377,4
DECEPTIVE PRACTICE,ATTEMPT - FINANCIAL IDENTITY THEFT,2015,510,504,6
DECEPTIVE PRACTICE,ATTEMPT - FINANCIAL IDENTITY THEFT,2016,546,545,1
DECEPTIVE PRACTICE,ATTEMPT - FINANCIAL IDENTITY THEFT,2017,661,659,2
DECEPTIVE PRACTICE,ATTEMPT - FINANCIAL IDENTITY THEFT,2018,458,454,4
DECEPTIVE PRACTICE,BOGUS CHECK,2008,1698,1510,188
DECEPTIVE PRACTICE,BOGUS CHECK,2009,1421,1285,136
DECEPTIVE PRACTICE,BOGUS CHECK,2010,1050,943,107
DECEPTIVE PRACTICE,BOGUS CHECK,2011,582,538,44
DECEPTIVE PRACTICE,BOGUS CHECK,2012,613,559,54
DECEPTIVE PRACTICE,BOGUS CHECK,2013,587,544,43
DECEPTIVE PRACTICE,BOGUS CHECK,2014,431,403,28
DECEPTIVE PRACTICE,BOGUS CHECK,2015,368,351,17
DECEPTIVE PRACTICE,BOGUS CHECK,2016,307,301,6
DECEPTIVE PRACTICE,BOGUS CHECK,2017,405,380,25
DECEPTIVE PRACTICE,BOGUS CHECK,2018,327,319,8
DECEPTIVE PRACTICE,COMPUTER FRAUD,2008,198,196,2
DECEPTIVE PRACTICE,COMPUTER FRAUD,2009,208,206,2
DECEPTIVE PRACTICE,COMPUTER FRAUD,2010,187,186,1
DECEPTIVE PRACTICE,COMPUTER FRAUD,2011,93,92,1
DECEPTIVE PRACTICE,COMPUTER FRAUD,2012,144,138,6
DECEPTIVE PRACTICE,COMPUTER FRAUD,2014,80,78,2
DECEPTIVE PRACTICE,COMPUTER FRAUD,2015,91,89,2
DECEPTIVE PRACTICE,COUNTERFEIT CHECK,2008,906,770,136
DECEPTIVE PRACTICE,COUNTERFEIT CHECK,2009,830,678,152
DECEPTIVE PRACTICE,COUNTERFEIT CHECK,2010,579,496,83
DECEPTIVE PRACTICE,COUNTERFEIT CHECK,2011,424,377,47
DECEPTIVE PRACTICE,COUNTERFEIT CHECK,2012,465,400,65
DECEPTIVE PRACTICE,COUNTERFEIT CHECK,2013,401,336,65
DECEPTIVE PRACTICE,COUNTERFEIT CHECK,2014,391,332,59
DECEPTIVE PRACTICE,COUNTERFEIT CHECK,2015,449,377,72
DECEPTIVE PRACTICE,COUNTERFEIT CHECK,2016,384,354,30
DECEPTIVE PRACTICE,COUNTERFEIT CHECK,2017,502,468,34
DECEPTIVE PRACTICE,COUNTERFEIT CHECK,2018,410,402,8
DECEPTIVE PRACTICE,COUNTERFEITING DOCUMENT,2008,1486,1222,264
DECEPTIVE PRACTICE,COUNTERFEITING DOCUMENT,2009,1522,1266,256
DECEPTIVE PRACTICE,COUNTERFEITING DOCUMENT,2010,1107,946,161
DECEPTIVE PRACTICE,COUNTERFEITING DOCUMENT,2011,454,369,85
DECEPTIVE PRACTICE,COUNTERFEITING DOCUMENT,2012,593,508,85
DECEPTIVE PRACTICE,COUNTERFEITING DOCUMENT,2013,566,478,88
DECEPTIVE PRACTICE,COUNTERFEITING DOCUMENT,2014,573,491,82
DECEPTIVE PRACTICE,COUNTERFEITING DOCUMENT,2015,652,585,67
DECEPTIVE PRACTICE,COUNTERFEITING DOCUMENT,2016,834,785,49
DECEPTIVE PRACTICE,COUNTERFEITING DOCUMENT,2017,846,788,58
DECEPTIVE PRACTICE,COUNTERFEITING DOCUMENT,2018,544,501,43
DECEPTIVE PRACTICE,CREDIT CARD FRAUD,2008,6094,5884,210
DECEPTIVE PRACTICE,CREDIT CARD FRAUD,2009,5256,5122,134
DECEPTIVE PRACTICE,CREDIT CARD FRAUD,2010,4458,4351,107
DECEPTIVE PRACTICE,CREDIT CARD FRAUD,2011,2540,2473,67
DECEPTIVE PRACTICE,CREDIT CARD FRAUD,2012,2842,2778,64
DECEPTIVE PRACTICE,CREDIT CARD FRAUD,2013,3268,3213,55
DECEPTIVE PRACTICE,CREDIT CARD FRAUD,2014,2982,2911,71
DECEPTIVE PRACTICE,CREDIT CARD FRAUD,2015,2942,2864,78
DECEPTIVE PRACTICE,CREDIT CARD FRAUD,2016,3035,2996,39
DECEPTIVE PRACTICE,CREDIT CARD FRAUD,2017,3833,3740,93
DECEPTIVE PRACTICE,CREDIT CARD FRAUD,2018,4304,4241,63
DECEPTIVE PRACTICE,DECEPTIVE COLLECTION PRACTICES,2008,60,46,14
DECEPTIVE PRACTICE,DECEPTIVE COLLECTION PRACTICES,2009,98,66,32
DECEPTIVE PRACTICE,DECEPTIVE COLLECTION PRACTICES,2010,141,123,18
DECEPTIVE PRACTICE,DECEPTIVE COLLECTION PRACTICES,2011,74,55,19
DECEPTIVE PRACTICE,DECEPTIVE COLLECTION PRACTICES,2012,70,52,18
DECEPTIVE PRACTICE,DECEPTIVE COLLECTION PRACTICES,2013,57,49,8
DECEPTIVE PRACTICE,DECEPTIVE COLLECTION PRACTICES,2014,54,47,7
DECEPTIVE PRACTICE,DECEPTIVE COLLECTION PRACTICES,2015,109,108,1
DECEPTIVE PRACTICE,DECEPTIVE COLLECTION PRACTICES,2016,23,20,3
DECEPTIVE PRACTICE,DECEPTIVE COLLECTION PRACTICES,2017,13,12,1
DECEPTIVE PRACTICE,EMBEZZLEMENT,2008,122,90,32
DECEPTIVE PRACTICE,EMBEZZLEMENT,2009,90,74,16
DECEPTIVE PRACTICE,EMBEZZLEMENT,2010,89,72,17
DECEPTIVE PRACTICE,EMBEZZLEMENT,2011,62,53,9
DECEPTIVE PRACTICE,EMBEZZLEMENT,2012,50,38,12
DECEPTIVE PRACTICE,EMBEZZLEMENT,2013,52,44,8
DECEPTIVE PRACTICE,EMBEZZLEMENT,2014,37,33,4
DECEPTIVE PRACTICE,EMBEZZLEMENT,2015,30,28,2
DECEPTIVE PRACTICE,EMBEZZLEMENT,2017,28,25,3
DECEPTIVE PRACTICE,EMBEZZLEMENT,2018,22,20,2
DECEPTIVE PRACTICE,FINAN EXPLOIT-ELDERLY/DISABLED,2008,194,184,10
DECEPTIVE PRACTICE,FINAN EXPLOIT-ELDERLY/DISABLED,2009,256,248,8
DECEPTIVE PRACTICE,FINAN EXPLOIT-ELDERLY/DISABLED,2010,205,197,8
DECEPTIVE PRACTICE,FINAN EXPLOIT-ELDERLY/DISABLED,2011,129,126,3
DECEPTIVE PRACTICE,FINAN EXPLOIT-ELDERLY/DISABLED,2012,107,101,6
DECEPTIVE PRACTICE,FINAN EXPLOIT-ELDERLY/DISABLED,2013,59,54,5
DECEPTIVE PRACTICE,FINAN EXPLOIT-ELDERLY/DISABLED,2014,67,63,4
DECEPTIVE PRACTICE,FINAN EXPLOIT-ELDERLY/DISABLED,2015,71,70,1
DECEPTIVE PRACTICE,FINAN EXPLOIT-ELDERLY/DISABLED,2016,31,29,2
DECEPTIVE PRACTICE,FINAN EXPLOIT-ELDERLY/DISABLED,2017,69,66,3
DECEPTIVE PRACTICE,FINANCIAL IDENTITY THEFT $300 AND UNDER,2014,876,868,8
DECEPTIVE PRACTICE,FINANCIAL IDENTITY THEFT $300 AND UNDER,2015,1413,1408,5
DECEPTIVE PRACTICE,FINANCIAL IDENTITY THEFT $300 AND UNDER,2016,1258,1243,15
DECEPTIVE PRACTICE,FINANCIAL IDENTITY THEFT $300 AND UNDER,2017,1605,1593,12
DECEPTIVE PRACTICE,FINANCIAL IDENTITY THEFT $300 AND UNDER,2018,1077,1072,5
DECEPTIVE PRACTICE,FINANCIAL IDENTITY THEFT OVER $ 300,2014,2745,2706,39
DECEPTIVE PRACTICE,FINANCIAL IDENTITY THEFT OVER $ 300,2015,3754,3726,28
DECEPTIVE PRACTICE,FINANCIAL IDENTITY THEFT OVER $ 300,2016,3259,3229,30
DECEPTIVE PRACTICE,FINANCIAL IDENTITY THEFT OVER $ 300,2017,4258,4202,56
DECEPTIVE PRACTICE,FINANCIAL IDENTITY THEFT OVER $ 300,2018,3343,3318,25
DECEPTIVE PRACTICE,FORGERY,2008,2150,1896,254
DECEPTIVE PRACTICE,FORGERY,2009,1872,1626,246
DECEPTIVE PRACTICE,FORGERY,2010,1282,1110,172
DECEPTIVE PRACTICE,FORGERY,2011,684,614,70
DECEPTIVE PRACTICE,FORGERY,2012,708,616,92
DECEPTIVE PRACTICE,FORGERY,2013,536,492,44
DECEPTIVE PRACTICE,FORGERY,2014,508,457,51
DECEPTIVE PRACTICE,FORGERY,2015,406,372,34
DECEPTIVE PRACTICE,FORGERY,2016,319,295,24
DECEPTIVE PRACTICE,FORGERY,2017,482,440,42
DECEPTIVE PRACTICE,FORGERY,2018,404,367,37
DECEPTIVE PRACTICE,FRAUD OR CONFIDENCE GAME,2008,3920,3608,312
DECEPTIVE PRACTICE,FRAUD OR CONFIDENCE GAME,2009,3430,3166,264
DECEPTIVE PRACTICE,FRAUD OR CONFIDENCE GAME,2010,2628,2400,228
DECEPTIVE PRACTICE,FRAUD OR CONFIDENCE GAME,2011,1334,1245,89
DECEPTIVE PRACTICE,FRAUD OR CONFIDENCE GAME,2012,1359,1277,82
DECEPTIVE PRACTICE,FRAUD OR CONFIDENCE GAME,2013,1297,1221,76
DECEPTIVE PRACTICE,FRAUD OR CONFIDENCE GAME,2014,1477,1429,48
DECEPTIVE PRACTICE,FRAUD OR CONFIDENCE GAME,2015,1381,1346,35
DECEPTIVE PRACTICE,FRAUD OR CONFIDENCE GAME,2016,1443,1430,13
DECEPTIVE PRACTICE,FRAUD OR CONFIDENCE GAME,2017,1764,1729,35
DECEPTIVE PRACTICE,FRAUD OR CONFIDENCE GAME,2018,1972,1953,19
DECEPTIVE PRACTICE,ILLEGAL POSSESSION CASH CARD,2008,94,86,8
DECEPTIVE PRACTICE,ILLEGAL POSSESSION CASH CARD,2010,111,90,21
DECEPTIVE PRACTICE,ILLEGAL POSSESSION CASH CARD,2011,57,54,3
DECEPTIVE PRACTICE,ILLEGAL POSSESSION CASH CARD,2012,58,47,11
DECEPTIVE PRACTICE,ILLEGAL POSSESSION CASH CARD,2013,70,55,15
DECEPTIVE PRACTICE,ILLEGAL POSSESSION CASH CARD,2014,38,24,14
DECEPTIVE PRACTICE,ILLEGAL POSSESSION CASH CARD,2015,31,22,9
DECEPTIVE PRACTICE,ILLEGAL POSSESSION CASH CARD,2016,18,16,2
DECEPTIVE PRACTICE,ILLEGAL POSSESSION CASH CARD,2017,24,19,5
DECEPTIVE PRACTICE,ILLEGAL POSSESSION CASH CARD,2018,35,28,7
DECEPTIVE PRACTICE,ILLEGAL USE CASH CARD,2008,5386,5338,48
DECEPTIVE PRACTICE,ILLEGAL USE CASH CARD,2009,5728,5690,38
DECEPTIVE PRACTICE,ILLEGAL USE CASH CARD,2010,5364,5349,15
DECEPTIVE PRACTICE,ILLEGAL USE CASH CARD,2011,2678,2670,8
DECEPTIVE PRACTICE,ILLEGAL USE CASH CARD,2012,2346,2332,14
DECEPTIVE PRACTICE,ILLEGAL USE CASH CARD,2013,2231,2213,18
DECEPTIVE PRACTICE,ILLEGAL USE CASH CARD,2014,1496,1487,9
DECEPTIVE PRACTICE,ILLEGAL USE CASH CARD,2015,1061,1051,10
DECEPTIVE PRACTICE,ILLEGAL USE CASH CARD,2016,1189,1187,2
DECEPTIVE PRACTICE,ILLEGAL USE CASH CARD,2017,1418,1412,6
DECEPTIVE PRACTICE,ILLEGAL USE CASH CARD,2018,1655,1644,11
DECEPTIVE PRACTICE,IMPERSONATION,2008,72,40,32
DECEPTIVE PRACTICE,IMPERSONATION,2009,80,38,42
DECEPTIVE PRACTICE,IMPERSONATION,2010,139,98,41
DECEPTIVE PRACTICE,IMPERSONATION,2011,47,36,11
DECEPTIVE PRACTICE,IMPERSONATION,2012,44,27,17
DECEPTIVE PRACTICE,IMPERSONATION,2013,39,27,12
DECEPTIVE PRACTICE,IMPERSONATION,2014,50,21,29
DECEPTIVE PRACTICE,IMPERSONATION,2015,24,16,8
DECEPTIVE PRACTICE,IMPERSONATION,2016,14,7,7
DECEPTIVE PRACTICE,IMPERSONATION,2018,16,12,4
DECEPTIVE PRACTICE,INSURANCE FRAUD,2008,12,10,2
DECEPTIVE PRACTICE,INSURANCE FRAUD,2009,16,12,4
DECEPTIVE PRACTICE,INSURANCE FRAUD,2011,7,6,1
DECEPTIVE PRACTICE,INSURANCE FRAUD,2012,7,6,1
DECEPTIVE PRACTICE,INSURANCE FRAUD,2014,3,2,1
DECEPTIVE PRACTICE,INSURANCE FRAUD,2015,4,3,1
DECEPTIVE PRACTICE,LIBRARY THEFT,2011,6,2,4
DECEPTIVE PRACTICE,LIBRARY THEFT,2012,5,1,4
DECEPTIVE PRACTICE,LIBRARY THEFT,2013,8,1,7
DECEPTIVE PRACTICE,LIBRARY THEFT,2014,4,0,4
DECEPTIVE PRACTICE,LIBRARY THEFT,2015,2,1,1
DECEPTIVE PRACTICE,LIBRARY THEFT,2016,2,0,2
DECEPTIVE PRACTICE,PAY TV SERVICE OFFENSES,2008,10,8,2
DECEPTIVE PRACTICE,PAY TV SERVICE OFFENSES,2009,18,16,2
DECEPTIVE PRACTICE,POSS. KEYS OR DEV.TO COIN MACH,2008,8,2,6
DECEPTIVE PRACTICE,POSS. KEYS OR DEV.TO COIN MACH,2009,2,0,2
DECEPTIVE PRACTICE,STOLEN PROP: BUY/RECEIVE/POS.,2008,262,82,180
DECEPTIVE PRACTICE,STOLEN PROP: BUY/RECEIVE/POS.,2009,200,48,152
DECEPTIVE PRACTICE,STOLEN PROP: BUY/RECEIVE/POS.,2010,258,76,182
DECEPTIVE PRACTICE,STOLEN PROP: BUY/RECEIVE/POS.,2011,89,23,66
DECEPTIVE PRACTICE,STOLEN PROP: BUY/RECEIVE/POS.,2012,103,32,71
DECEPTIVE PRACTICE,STOLEN PROP: BUY/RECEIVE/POS.,2013,117,38,79
DECEPTIVE PRACTICE,STOLEN PROP: BUY/RECEIVE/POS.,2014,75,20,55
DECEPTIVE PRACTICE,STOLEN PROP: BUY/RECEIVE/POS.,2015,55,22,33
DECEPTIVE PRACTICE,STOLEN PROP: BUY/RECEIVE/POS.,2016,43,16,27
DECEPTIVE PRACTICE,STOLEN PROP: BUY/RECEIVE/POS.,2017,41,22,19
DECEPTIVE PRACTICE,STOLEN PROP: BUY/RECEIVE/POS.,2018,81,52,29
DECEPTIVE PRACTICE,"THEFT BY LESSEE,MOTOR VEH",2008,446,364,82
DECEPTIVE PRACTICE,"THEFT BY LESSEE,MOTOR VEH",2009,328,252,76
DECEPTIVE PRACTICE,"THEFT BY LESSEE,MOTOR VEH",2010,315,258,57
DECEPTIVE PRACTICE,"THEFT BY LESSEE,MOTOR VEH",2011,139,116,23
DECEPTIVE PRACTICE,"THEFT BY LESSEE,MOTOR VEH",2012,177,145,32
DECEPTIVE PRACTICE,"THEFT BY LESSEE,MOTOR VEH",2013,150,124,26
DECEPTIVE PRACTICE,"THEFT BY LESSEE,MOTOR VEH",2014,145,115,30
DECEPTIVE PRACTICE,"THEFT BY LESSEE,MOTOR VEH",2015,153,132,21
DECEPTIVE PRACTICE,"THEFT BY LESSEE,MOTOR VEH",2016,145,128,17
DECEPTIVE PRACTICE,"THEFT BY LESSEE,MOTOR VEH",2017,338,303,35
DECEPTIVE PRACTICE,"THEFT BY LESSEE,MOTOR VEH",2018,406,388,18
DECEPTIVE PRACTICE,"THEFT BY LESSEE,NON-VEH",2008,50,44,6
DECEPTIVE PRACTICE,"THEFT BY LESSEE,NON-VEH",2009,36,34,2
DECEPTIVE PRACTICE,"THEFT BY LESSEE,NON-VEH",2010,29,27,2
DECEPTIVE PRACTICE,"THEFT BY LESSEE,NON-VEH",2012,8,7,1
DECEPTIVE PRACTICE,"THEFT BY LESSEE,NON-VEH",2014,9,8,1
DECEPTIVE PRACTICE,"THEFT BY LESSEE,NON-VEH",2018,10,7,3
DECEPTIVE PRACTICE,THEFT OF LABOR/SERVICES,2008,3914,2394,1520
DECEPTIVE PRACTICE,THEFT OF LABOR/SERVICES,2009,3778,1484,2294
DECEPTIVE PRACTICE,THEFT OF LABOR/SERVICES,2010,3237,1337,1900
DECEPTIVE PRACTICE,THEFT OF LABOR/SERVICES,2011,2006,646,1360
DECEPTIVE PRACTICE,THEFT OF LABOR/SERVICES,2012,2596,711,1885
DECEPTIVE PRACTICE,THEFT OF LABOR/SERVICES,2013,2130,608,1522
DECEPTIVE PRACTICE,THEFT OF LABOR/SERVICES,2014,1317,525,792
DECEPTIVE PRACTICE,THEFT OF LABOR/SERVICES,2015,758,476,282
DECEPTIVE PRACTICE,THEFT OF LABOR/SERVICES,2016,803,569,234
DECEPTIVE PRACTICE,THEFT OF LABOR/SERVICES,2017,912,692,220
DECEPTIVE PRACTICE,THEFT OF LABOR/SERVICES,2018,821,585,236
DECEPTIVE PRACTICE,THEFT OF LOST/MISLAID PROP,2008,1008,402,606
DECEPTIVE PRACTICE,THEFT OF LOST/MISLAID PROP,2009,882,178,704
DECEPTIVE PRACTICE,THEFT OF LOST/MISLAID PROP,2010,807,192,615
DECEPTIVE PRACTICE,THEFT OF LOST/MISLAID PROP,2011,457,75,382
DECEPTIVE PRACTICE,THEFT OF LOST/MISLAID PROP,2012,381,51,330
DECEPTIVE PRACTICE,THEFT OF LOST/MISLAID PROP,2013,377,80,297
DECEPTIVE PRACTICE,THEFT OF LOST/MISLAID PROP,2014,416,97,319
DECEPTIVE PRACTICE,THEFT OF LOST/MISLAID PROP,2015,276,59,217
DECEPTIVE PRACTICE,THEFT OF LOST/MISLAID PROP,2016,175,55,120
DECEPTIVE PRACTICE,THEFT OF LOST/MISLAID PROP,2017,167,39,128
DECEPTIVE PRACTICE,THEFT OF LOST/MISLAID PROP,2018,292,80,212
DECEPTIVE PRACTICE,UNAUTHORIZED VIDEOTAPING,2008,22,14,8
DECEPTIVE PRACTICE,UNAUTHORIZED VIDEOTAPING,2009,12,4,8
DECEPTIVE PRACTICE,UNAUTHORIZED VIDEOTAPING,2010,27,15,12
DECEPTIVE PRACTICE,UNAUTHORIZED VIDEOTAPING,2011,26,8,18
DECEPTIVE PRACTICE,UNAUTHORIZED VIDEOTAPING,2012,13,10,3
DECEPTIVE PRACTICE,UNAUTHORIZED VIDEOTAPING,2013,17,12,5
DECEPTIVE PRACTICE,UNAUTHORIZED VIDEOTAPING,2014,35,29,6
DECEPTIVE PRACTICE,UNAUTHORIZED VIDEOTAPING,2015,31,23,8
DECEPTIVE PRACTICE,UNAUTHORIZED VIDEOTAPING,2016,30,23,7
DECEPTIVE PRACTICE,UNAUTHORIZED VIDEOTAPING,2017,50,42,8
DECEPTIVE PRACTICE,UNAUTHORIZED VIDEOTAPING,2018,41,39,2
DECEPTIVE PRACTICE,UNIDENTIFIABLE RECORDING SOUND,2008,42,6,36
DECEPTIVE PRACTICE,UNIDENTIFIABLE RECORDING SOUND,2009,54,2,52
DECEPTIVE PRACTICE,UNIDENTIFIABLE RECORDING SOUND,2010,69,11,58
DECEPTIVE PRACTICE,UNIDENTIFIABLE RECORDING SOUND,2011,39,4,35
DECEPTIVE PRACTICE,UNIDENTIFIABLE RECORDING SOUND,2012,43,2,41
DECEPTIVE PRACTICE,UNIDENTIFIABLE RECORDING SOUND,2013,17,0,17
DECEPTIVE PRACTICE,UNIDENTIFIABLE RECORDING SOUND,2014,13,2,11
DECEPTIVE PRACTICE,UNIDENTIFIABLE RECORDING SOUND,2015,4,0,4
DECEPTIVE PRACTICE,UNIDENTIFIABLE RECORDING SOUND,2017,1,0,1
DECEPTIVE PRACTICE,UNIDENTIFIABLE RECORDING SOUND,2018,1,0,1
DECEPTIVE PRACTICE,UNLAWFUL USE OF A COMPUTER,2008,60,58,2
DECEPTIVE PRACTICE,UNLAWFUL USE OF A COMPUTER,2009,64,60,4
DECEPTIVE PRACTICE,UNLAWFUL USE OF A COMPUTER,2012,23,22,1
DECEPTIVE PRACTICE,UNLAWFUL USE OF A COMPUTER,2014,10,9,1
DECEPTIVE PRACTICE,UNLAWFUL USE OF A COMPUTER,2016,10,9,1
DECEPTIVE PRACTICE,UNLAWFUL USE OF RECORDED SOUND,2008,336,24,312
DECEPTIVE PRACTICE,UNLAWFUL USE OF RECORDED SOUND,2009,244,12,232
DECEPTIVE PRACTICE,UNLAWFUL USE OF RECORDED SOUND,2010,172,13,159
DECEPTIVE PRACTICE,UNLAWFUL USE OF RECORDED SOUND,2011,123,6,117
DECEPTIVE PRACTICE,UNLAWFUL USE OF RECORDED SOUND,2012,61,3,58
DECEPTIVE PRACTICE,UNLAWFUL USE OF RECORDED SOUND,2013,108,13,95
DECEPTIVE PRACTICE,UNLAWFUL USE OF RECORDED SOUND,2014,77,18,59
DECEPTIVE PRACTICE,UNLAWFUL USE OF RECORDED SOUND,2015,18,2,16
DECEPTIVE PRACTICE,UNLAWFUL USE OF RECORDED SOUND,2016,11,1,10
DECEPTIVE PRACTICE,UNLAWFUL USE OF RECORDED SOUND,2017,9,2,7
DECEPTIVE PRACTICE,UNLAWFUL USE OF RECORDED SOUND,2018,1,0,1
GAMBLING,BOLITA OR BOLI PUL/OFFICE,2008,2,0,2
GAMBLING,BOLITA OR BOLI PUL/WRITER,2008,2,0,2
GAMBLING,BOOKMAKING/HORSES,2008,6,0,6
GAMBLING,BOOKMAKING/SPORTS,2008,10,0,10
GAMBLING,BOOKMAKING/SPORTS,2009,8,0,8
GAMBLING,BOOKMAKING/SPORTS,2011,1,0,1
GAMBLING,BOOKMAKING/SPORTS,2012,3,0,3
GAMBLING,GAME/AMUSEMENT DEVICE,2008,68,0,68
GAMBLING,GAME/AMUSEMENT DEVICE,2009,56,0,56
GAMBLING,GAME/AMUSEMENT DEVICE,2010,23,0,23
GAMBLING,GAME/AMUSEMENT DEVICE,2011,11,0,11
GAMBLING,GAME/AMUSEMENT DEVICE,2012,6,0,6
GAMBLING,GAME/AMUSEMENT DEVICE,2013,8,1,7
GAMBLING,GAME/AMUSEMENT DEVICE,2014,6,0,6
GAMBLING,GAME/AMUSEMENT DEVICE,2015,17,0,17
GAMBLING,GAME/AMUSEMENT DEVICE,2016,4,0,4
GAMBLING,GAME/AMUSEMENT DEVICE,2017,1,0,1
GAMBLING,GAME/AMUSEMENT DEVICE,2018,7,0,7
GAMBLING,GAME/CARDS,2008,64,2,62
GAMBLING,GAME/CARDS,2009,36,2,34
GAMBLING,GAME/CARDS,2010,12,0,12
GAMBLING,GAME/CARDS,2011,11,0,11
GAMBLING,GAME/CARDS,2012,3,0,3
GAMBLING,GAME/CARDS,2013,1,0,1
GAMBLING,GAME/CARDS,2014,3,0,3
GAMBLING,GAME/CARDS,2015,6,0,6
GAMBLING,GAME/CARDS,2016,1,0,1
GAMBLING,GAME/CARDS,2017,5,0,5
GAMBLING,GAME/DICE,2008,2054,60,1994
GAMBLING,GAME/DICE,2009,1774,4,1770
GAMBLING,GAME/DICE,2010,1754,0,1754
GAMBLING,GAME/DICE,2011,698,0,698
GAMBLING,GAME/DICE,2012,698,1,697
GAMBLING,GAME/DICE,2013,573,4,569
GAMBLING,GAME/DICE,2014,373,1,372
GAMBLING,GAME/DICE,2015,280,0,280
GAMBLING,GAME/DICE,2016,180,0,180
GAMBLING,GAME/DICE,2017,180,0,180
GAMBLING,GAME/DICE,2018,185,0,185
GAMBLING,ILLEGAL ILL LOTTERY,2008,62,2,60
GAMBLING,ILLEGAL ILL LOTTERY,2009,2,0,2
GAMBLING,LOTTERY/OTHER,2011,1,0,1
GAMBLING,OTHER,2008,82,0,82
GAMBLING,OTHER,2009,48,2,46
GAMBLING,OTHER,2010,41,0,41
GAMBLING,OTHER,2011,13,0,13
GAMBLING,OTHER,2012,14,0,14
GAMBLING,OTHER,2013,14,0,14
GAMBLING,OTHER,2014,11,0,11
GAMBLING,OTHER,2015,7,0,7
GAMBLING,OTHER,2016,3,0,3
GAMBLING,OTHER,2017,5,0,5
GAMBLING,OTHER,2018,7,0,7
GAMBLING,REGISTER FED GAMBLING STAMP,2008,2,0,2
GAMBLING,VIOL CHARITABLE GAME ACT,2008,4,0,4
GAMBLING,WIREROOM/SPORTS,2010,2,0,2
GAMBLING,WIREROOM/SPORTS,2011,1,0,1
HOMICIDE,FIRST DEGREE MURDER,2008,513,250,263
HOMICIDE,FIRST DEGREE MURDER,2009,460,242,218
HOMICIDE,FIRST DEGREE MURDER,2010,438,247,191
HOMICIDE,FIRST DEGREE MURDER,2011,436,259,177
HOMICIDE,FIRST DEGREE MURDER,2012,502,296,206
HOMICIDE,FIRST DEGREE MURDER,2013,418,246,172
HOMICIDE,FIRST DEGREE MURDER,2014,421,255,166
HOMICIDE,FIRST DEGREE MURDER,2015,461,311,150
HOMICIDE,FIRST DEGREE MURDER,2016,746,589,157
HOMICIDE,FIRST DEGREE MURDER,2017,671,514,157
HOMICIDE,FIRST DEGREE MURDER,2018,547,442,105
HOMICIDE,INVOLUNTARY MANSLAUGHTER,2014,1,0,1
HOMICIDE,RECKLESS HOMICIDE,2011,1,0,1
HOMICIDE,RECKLESS HOMICIDE,2012,1,0,1
HOMICIDE,RECKLESS HOMICIDE,2014,1,0,1
HOMICIDE,RECKLESS HOMICIDE,2015,5,1,4
HOMICIDE,RECKLESS HOMICIDE,2016,3,2,1
HOMICIDE,RECKLESS HOMICIDE,2017,3,0,3
HOMICIDE,RECKLESS HOMICIDE,2018,8,1,7
HUMAN TRAFFICKING,COMMERCIAL SEX ACTS,2015,4,2,2
HUMAN TRAFFICKING,COMMERCIAL SEX ACTS,2018,10,9,1
HUMAN TRAFFICKING,INVOLUNTARY SERVITUDE,2017,2,1,1
INTERFERENCE WITH PUBLIC OFFICER,AIDING ARRESTEE ESCAPE,2008,8,4,4
INTERFERENCE WITH PUBLIC OFFICER,AIDING ARRESTEE ESCAPE,2010,4,2,2
INTERFERENCE WITH PUBLIC OFFICER,AIDING ARRESTEE ESCAPE,2011,1,0,1
INTERFERENCE WITH PUBLIC OFFICER,AIDING ARRESTEE ESCAPE,2015,2,0,2
INTERFERENCE WITH PUBLIC OFFICER,BRIBERY,2008,20,6,14
INTERFERENCE WITH PUBLIC OFFICER,BRIBERY,2009,6,4,2
INTERFERENCE WITH PUBLIC OFFICER,BRIBERY,2010,14,8,6
INTERFERENCE WITH PUBLIC OFFICER,BRIBERY,2011,8,1,7
INTERFERENCE WITH PUBLIC OFFICER,BRIBERY,2012,5,2,3
INTERFERENCE WITH PUBLIC OFFICER,BRIBERY,2013,4,1,3
INTERFERENCE WITH PUBLIC OFFICER,BRIBERY,2014,5,4,1
INTERFERENCE WITH PUBLIC OFFICER,BRIBERY,2016,5,1,4
INTERFERENCE WITH PUBLIC OFFICER,BRIBERY,2017,3,2,1
INTERFERENCE WITH PUBLIC OFFICER,CONCEALING/AIDING A FUGITIVE,2008,2,0,2
INTERFERENCE WITH PUBLIC OFFICER,CONCEALING/AIDING A FUGITIVE,2009,4,0,4
INTERFERENCE WITH PUBLIC OFFICER,CONCEALING/AIDING A FUGITIVE,2010,2,0,2
INTERFERENCE WITH PUBLIC OFFICER,CONCEALING/AIDING A FUGITIVE,2011,1,0,1
INTERFERENCE WITH PUBLIC OFFICER,CONCEALING/AIDING A FUGITIVE,2013,3,0,3
INTERFERENCE WITH PUBLIC OFFICER,CONCEALING/AIDING A FUGITIVE,2016,2,0,2
INTERFERENCE WITH PUBLIC OFFICER,CONTRABAND IN PRISON,2010,1,0,1
INTERFERENCE WITH PUBLIC OFFICER,CONTRABAND IN PRISON,2011,1,0,1
INTERFERENCE WITH PUBLIC OFFICER,ESCAPE,2008,36,16,20
INTERFERENCE WITH PUBLIC OFFICER,ESCAPE,2009,28,0,28
INTERFERENCE WITH PUBLIC OFFICER,ESCAPE,2010,24,13,11
INTERFERENCE WITH PUBLIC OFFICER,ESCAPE,2011,15,1,14
INTERFERENCE WITH PUBLIC OFFICER,ESCAPE,2012,10,3,7
INTERFERENCE WITH PUBLIC OFFICER,ESCAPE,2013,16,1,15
INTERFERENCE WITH PUBLIC OFFICER,ESCAPE,2014,15,3,12
INTERFERENCE WITH PUBLIC OFFICER,ESCAPE,2015,13,5,8
INTERFERENCE WITH PUBLIC OFFICER,ESCAPE,2016,10,4,6
INTERFERENCE WITH PUBLIC OFFICER,ESCAPE,2017,10,1,9
INTERFERENCE WITH PUBLIC OFFICER,ESCAPE,2018,13,4,9
INTERFERENCE WITH PUBLIC OFFICER,INTERFERENCE JUDICIAL PROCESS,2008,90,32,58
INTERFERENCE WITH PUBLIC OFFICER,INTERFERENCE JUDICIAL PROCESS,2009,98,36,62
INTERFERENCE WITH PUBLIC OFFICER,INTERFERENCE JUDICIAL PROCESS,2010,43,6,37
INTERFERENCE WITH PUBLIC OFFICER,INTERFERENCE JUDICIAL PROCESS,2011,16,6,10
INTERFERENCE WITH PUBLIC OFFICER,INTERFERENCE JUDICIAL PROCESS,2012,23,10,13
INTERFERENCE WITH PUBLIC OFFICER,INTERFERENCE JUDICIAL PROCESS,2013,22,16,6
INTERFERENCE WITH PUBLIC OFFICER,INTERFERENCE JUDICIAL PROCESS,2014,11,5,6
INTERFERENCE WITH PUBLIC OFFICER,INTERFERENCE JUDICIAL PROCESS,2015,20,10,10
INTERFERENCE WITH PUBLIC OFFICER,INTERFERENCE JUDICIAL PROCESS,2016,15,10,5
INTERFERENCE WITH PUBLIC OFFICER,INTERFERENCE JUDICIAL PROCESS,2017,18,16,2
INTERFERENCE WITH PUBLIC OFFICER,INTERFERENCE JUDICIAL PROCESS,2018,12,7,5
INTERFERENCE WITH PUBLIC OFFICER,OBSTRUCTING IDENTIFICATION,2011,294,16,278
INTERFERENCE WITH PUBLIC OFFICER,OBSTRUCTING IDENTIFICATION,2012,665,23,642
INTERFERENCE WITH PUBLIC OFFICER,OBSTRUCTING IDENTIFICATION,2013,722,27,695
INTERFERENCE WITH PUBLIC OFFICER,OBSTRUCTING IDENTIFICATION,2014,823,41,782
INTERFERENCE WITH PUBLIC OFFICER,OBSTRUCTING IDENTIFICATION,2015,810,21,789
INTERFERENCE WITH PUBLIC OFFICER,OBSTRUCTING IDENTIFICATION,2016,538,7,531
INTERFERENCE WITH PUBLIC OFFICER,OBSTRUCTING IDENTIFICATION,2017,659,16,643
INTERFERENCE WITH PUBLIC OFFICER,OBSTRUCTING IDENTIFICATION,2018,802,14,788
INTERFERENCE WITH PUBLIC OFFICER,OBSTRUCTING JUSTICE,2008,302,48,254
INTERFERENCE WITH PUBLIC OFFICER,OBSTRUCTING JUSTICE,2009,272,20,252
INTERFERENCE WITH PUBLIC OFFICER,OBSTRUCTING JUSTICE,2010,620,69,551
INTERFERENCE WITH PUBLIC OFFICER,OBSTRUCTING JUSTICE,2011,313,22,291
INTERFERENCE WITH PUBLIC OFFICER,OBSTRUCTING JUSTICE,2012,129,8,121
INTERFERENCE WITH PUBLIC OFFICER,OBSTRUCTING JUSTICE,2013,105,13,92
INTERFERENCE WITH PUBLIC OFFICER,OBSTRUCTING JUSTICE,2014,113,9,104
INTERFERENCE WITH PUBLIC OFFICER,OBSTRUCTING JUSTICE,2015,80,1,79
INTERFERENCE WITH PUBLIC OFFICER,OBSTRUCTING JUSTICE,2016,35,2,33
INTERFERENCE WITH PUBLIC OFFICER,OBSTRUCTING JUSTICE,2017,66,4,62
INTERFERENCE WITH PUBLIC OFFICER,OBSTRUCTING JUSTICE,2018,81,5,76
INTERFERENCE WITH PUBLIC OFFICER,OBSTRUCTING SERVICE,2008,52,14,38
INTERFERENCE WITH PUBLIC OFFICER,OBSTRUCTING SERVICE,2009,44,2,42
INTERFERENCE WITH PUBLIC OFFICER,OBSTRUCTING SERVICE,2010,106,20,86
INTERFERENCE WITH PUBLIC OFFICER,OBSTRUCTING SERVICE,2011,53,6,47
INTERFERENCE WITH PUBLIC OFFICER,OBSTRUCTING SERVICE,2012,37,4,33
INTERFERENCE WITH PUBLIC OFFICER,OBSTRUCTING SERVICE,2013,53,8,45
INTERFERENCE WITH PUBLIC OFFICER,OBSTRUCTING SERVICE,2014,31,1,30
INTERFERENCE WITH PUBLIC OFFICER,OBSTRUCTING SERVICE,2015,36,3,33
INTERFERENCE WITH PUBLIC OFFICER,OBSTRUCTING SERVICE,2016,33,1,32
INTERFERENCE WITH PUBLIC OFFICER,OBSTRUCTING SERVICE,2017,20,4,16
INTERFERENCE WITH PUBLIC OFFICER,OBSTRUCTING SERVICE,2018,28,4,24
INTERFERENCE WITH PUBLIC OFFICER,OFFICIAL MISCONDUCT,2008,4,2,2
INTERFERENCE WITH PUBLIC OFFICER,OFFICIAL MISCONDUCT,2010,5,1,4
INTERFERENCE WITH PUBLIC OFFICER,OFFICIAL MISCONDUCT,2014,2,1,1
INTERFERENCE WITH PUBLIC OFFICER,OFFICIAL MISCONDUCT,2016,2,1,1
INTERFERENCE WITH PUBLIC OFFICER,OFFICIAL MISCONDUCT,2017,1,0,1
INTERFERENCE WITH PUBLIC OFFICER,REFUSING TO AID AN OFFICER,2008,6,2,4
INTERFERENCE WITH PUBLIC OFFICER,REFUSING TO AID AN OFFICER,2010,2,0,2
INTERFERENCE WITH PUBLIC OFFICER,RESIST/OBSTRUCT/DISARM OFFICER,2008,628,108,520
INTERFERENCE WITH PUBLIC OFFICER,RESIST/OBSTRUCT/DISARM OFFICER,2009,674,22,652
INTERFERENCE WITH PUBLIC OFFICER,RESIST/OBSTRUCT/DISARM OFFICER,2010,698,72,626
INTERFERENCE WITH PUBLIC OFFICER,RESIST/OBSTRUCT/DISARM OFFICER,2011,346,14,332
INTERFERENCE WITH PUBLIC OFFICER,RESIST/OBSTRUCT/DISARM OFFICER,2012,359,16,343
INTERFERENCE WITH PUBLIC OFFICER,RESIST/OBSTRUCT/DISARM OFFICER,2013,355,12,343
INTERFERENCE WITH PUBLIC OFFICER,RESIST/OBSTRUCT/DISARM OFFICER,2014,397,11,386
INTERFERENCE WITH PUBLIC OFFICER,RESIST/OBSTRUCT/DISARM OFFICER,2015,343,13,330
INTERFERENCE WITH PUBLIC OFFICER,RESIST/OBSTRUCT/DISARM OFFICER,2016,285,20,265
INTERFERENCE WITH PUBLIC OFFICER,RESIST/OBSTRUCT/DISARM OFFICER,2017,306,11,295
INTERFERENCE WITH PUBLIC OFFICER,RESIST/OBSTRUCT/DISARM OFFICER,2018,301,26,275
INTIMIDATION,COMPELLING CONFESSION,2014,1,0,1
INTIMIDATION,COMPELLING CONFESSION,2018,1,0,1
INTIMIDATION,COMPELLING ORG MEMBERSHIP,2008,10,6,4
INTIMIDATION,COMPELLING ORG MEMBERSHIP,2009,24,22,2
INTIMIDATION,COMPELLING ORG MEMBERSHIP,2012,3,2,1
INTIMIDATION,COMPELLING ORG MEMBERSHIP,2014,1,0,1
INTIMIDATION,COMPELLING ORG MEMBERSHIP,2015,2,1,1
INTIMIDATION,EDUCATIONAL INTIMIDAITON,2008,6,4,2
INTIMIDATION,EDUCATIONAL INTIMIDAITON,2010,4,2,2
INTIMIDATION,EXTORTION,2008,22,20,2
INTIMIDATION,EXTORTION,2009,38,32,6
INTIMIDATION,EXTORTION,2010,24,22,2
INTIMIDATION,EXTORTION,2011,21,20,1
INTIMIDATION,EXTORTION,2012,12,11,1
INTIMIDATION,EXTORTION,2013,10,9,1
INTIMIDATION,EXTORTION,2014,14,12,2
INTIMIDATION,EXTORTION,2015,20,17,3
INTIMIDATION,INTIMIDATION,2008,474,370,104
INTIMIDATION,INTIMIDATION,2009,394,324,70
INTIMIDATION,INTIMIDATION,2010,348,308,40
INTIMIDATION,INTIMIDATION,2011,142,102,40
INTIMIDATION,INTIMIDATION,2012,140,108,32
INTIMIDATION,INTIMIDATION,2013,121,102,19
INTIMIDATION,INTIMIDATION,2014,100,77,23
INTIMIDATION,INTIMIDATION,2015,95,78,17
INTIMIDATION,INTIMIDATION,2016,86,72,14
INTIMIDATION,INTIMIDATION,2017,88,74,14
INTIMIDATION,INTIMIDATION,2018,77,68,9
KIDNAPPING,AGGRAVATED,2008,48,44,4
KIDNAPPING,AGGRAVATED,2009,38,28,10
KIDNAPPING,AGGRAVATED,2010,42,30,12
KIDNAPPING,AGGRAVATED,2011,10,8,2
KIDNAPPING,AGGRAVATED,2012,10,7,3
KIDNAPPING,AGGRAVATED,2013,17,10,7
KIDNAPPING,AGGRAVATED,2014,13,9,4
KIDNAPPING,AGGRAVATED,2015,9,8,1
KIDNAPPING,AGGRAVATED,2018,9,8,1
KIDNAPPING,CHILD ABDUCTION/STRANGER,2008,364,338,26
KIDNAPPING,CHILD ABDUCTION/STRANGER,2009,262,246,16
KIDNAPPING,CHILD ABDUCTION/STRANGER,2010,282,266,16
KIDNAPPING,CHILD ABDUCTION/STRANGER,2011,123,109,14
KIDNAPPING,CHILD ABDUCTION/STRANGER,2012,99,90,9
KIDNAPPING,CHILD ABDUCTION/STRANGER,2013,89,77,12
KIDNAPPING,CHILD ABDUCTION/STRANGER,2014,95,86,9
KIDNAPPING,CHILD ABDUCTION/STRANGER,2015,71,64,7
KIDNAPPING,CHILD ABDUCTION/STRANGER,2016,59,56,3
KIDNAPPING,CHILD ABDUCTION/STRANGER,2017,75,68,7
KIDNAPPING,CHILD ABDUCTION/STRANGER,2018,78,75,3
KIDNAPPING,FORCIBLE DETENTION,2008,16,14,2
KIDNAPPING,FORCIBLE DETENTION,2009,8,6,2
KIDNAPPING,FORCIBLE DETENTION,2010,13,12,1
KIDNAPPING,FORCIBLE DETENTION,2012,6,5,1
KIDNAPPING,FORCIBLE DETENTION,2017,3,2,1
KIDNAPPING,KIDNAPPING,2008,76,62,14
KIDNAPPING,KIDNAPPING,2009,76,66,10
KIDNAPPING,KIDNAPPING,2010,44,42,2
KIDNAPPING,KIDNAPPING,2011,25,23,2
KIDNAPPING,KIDNAPPING,2012,18,15,3
KIDNAPPING,KIDNAPPING,2013,21,18,3
KIDNAPPING,KIDNAPPING,2015,19,18,1
KIDNAPPING,KIDNAPPING,2016,24,20,4
KIDNAPPING,KIDNAPPING,2017,20,18,2
KIDNAPPING,UNLAWFUL INTERFERE/VISITATION,2011,51,50,1
KIDNAPPING,UNLAWFUL INTERFERE/VISITATION,2013,79,75,4
KIDNAPPING,UNLAWFUL INTERFERE/VISITATION,2016,63,62,1
KIDNAPPING,UNLAWFUL INTERFERE/VISITATION,2018,32,29,3
KIDNAPPING,UNLAWFUL RESTRAINT,2008,124,94,30
KIDNAPPING,UNLAWFUL RESTRAINT,2009,114,94,20
KIDNAPPING,UNLAWFUL RESTRAINT,2010,124,104,20
KIDNAPPING,UNLAWFUL RESTRAINT,2011,54,42,12
KIDNAPPING,UNLAWFUL RESTRAINT,2012,31,26,5
KIDNAPPING,UNLAWFUL RESTRAINT,2013,34,26,8
KIDNAPPING,UNLAWFUL RESTRAINT,2014,32,27,5
KIDNAPPING,UNLAWFUL RESTRAINT,2015,33,27,6
KIDNAPPING,UNLAWFUL RESTRAINT,2016,37,35,2
KIDNAPPING,UNLAWFUL RESTRAINT,2017,37,31,6
KIDNAPPING,UNLAWFUL RESTRAINT,2018,29,28,1
LIQUOR LAW VIOLATION,EMPLOY MINOR,2008,2,0,2
LIQUOR LAW VIOLATION,EMPLOY MINOR,2009,2,0,2
LIQUOR LAW VIOLATION,EMPLOY MINOR,2013,1,0,1
LIQUOR LAW VIOLATION,ILLEGAL CONSUMPTION BY MINOR,2008,568,24,544
LIQUOR LAW VIOLATION,ILLEGAL CONSUMPTION BY MINOR,2009,398,4,394
LIQUOR LAW VIOLATION,ILLEGAL CONSUMPTION BY MINOR,2010,240,2,238
LIQUOR LAW VIOLATION,ILLEGAL CONSUMPTION BY MINOR,2011,105,1,104
LIQUOR LAW VIOLATION,ILLEGAL CONSUMPTION BY MINOR,2012,69,2,67
LIQUOR LAW VIOLATION,ILLEGAL CONSUMPTION BY MINOR,2013,71,0,71
LIQUOR LAW VIOLATION,ILLEGAL CONSUMPTION BY MINOR,2014,53,0,53
LIQUOR LAW VIOLATION,ILLEGAL CONSUMPTION BY MINOR,2015,36,0,36
LIQUOR LAW VIOLATION,ILLEGAL CONSUMPTION BY MINOR,2016,20,0,20
LIQUOR LAW VIOLATION,ILLEGAL CONSUMPTION BY MINOR,2017,14,0,14
LIQUOR LAW VIOLATION,ILLEGAL CONSUMPTION BY MINOR,2018,14,0,14
LIQUOR LAW VIOLATION,ILLEGAL POSSESSION BY MINOR,2008,654,8,646
LIQUOR LAW VIOLATION,ILLEGAL POSSESSION BY MINOR,2009,544,0,544
LIQUOR LAW VIOLATION,ILLEGAL POSSESSION BY MINOR,2010,455,0,455
LIQUOR LAW VIOLATION,ILLEGAL POSSESSION BY MINOR,2011,217,1,216
LIQUOR LAW VIOLATION,ILLEGAL POSSESSION BY MINOR,2012,208,2,206
LIQUOR LAW VIOLATION,ILLEGAL POSSESSION BY MINOR,2013,143,0,143
LIQUOR LAW VIOLATION,ILLEGAL POSSESSION BY MINOR,2014,102,0,102
LIQUOR LAW VIOLATION,ILLEGAL POSSESSION BY MINOR,2015,67,0,67
LIQUOR LAW VIOLATION,ILLEGAL POSSESSION BY MINOR,2016,46,0,46
LIQUOR LAW VIOLATION,ILLEGAL POSSESSION BY MINOR,2017,30,0,30
LIQUOR LAW VIOLATION,ILLEGAL POSSESSION BY MINOR,2018,22,0,22
LIQUOR LAW VIOLATION,LIQUOR LICENSE VIOLATION,2008,286,6,280
LIQUOR LAW VIOLATION,LIQUOR LICENSE VIOLATION,2009,242,6,236
LIQUOR LAW VIOLATION,LIQUOR LICENSE VIOLATION,2010,306,0,306
LIQUOR LAW VIOLATION,LIQUOR LICENSE VIOLATION,2011,141,1,140
LIQUOR LAW VIOLATION,LIQUOR LICENSE VIOLATION,2012,145,3,142
LIQUOR LAW VIOLATION,LIQUOR LICENSE VIOLATION,2013,155,11,144
LIQUOR LAW VIOLATION,LIQUOR LICENSE VIOLATION,2014,159,7,152
LIQUOR LAW VIOLATION,LIQUOR LICENSE VIOLATION,2015,132,1,131
LIQUOR LAW VIOLATION,LIQUOR LICENSE VIOLATION,2016,129,1,128
LIQUOR LAW VIOLATION,LIQUOR LICENSE VIOLATION,2017,102,0,102
LIQUOR LAW VIOLATION,LIQUOR LICENSE VIOLATION,2018,100,0,100
LIQUOR LAW VIOLATION,MINOR MISREPRESENT AGE,2008,32,0,32
LIQUOR LAW VIOLATION,MINOR MISREPRESENT AGE,2009,6,0,6
LIQUOR LAW VIOLATION,MINOR MISREPRESENT AGE,2010,2,0,2
LIQUOR LAW VIOLATION,MINOR MISREPRESENT AGE,2012,1,0,1
LIQUOR LAW VIOLATION,MINOR MISREPRESENT AGE,2014,1,0,1
LIQUOR LAW VIOLATION,MINOR MISREPRESENT AGE,2015,1,0,1
LIQUOR LAW VIOLATION,MINOR MISREPRESENT AGE,2016,1,0,1
LIQUOR LAW VIOLATION,MINOR MISREPRESENT AGE,2017,1,0,1
LIQUOR LAW VIOLATION,SELL/GIVE/DEL LIQUOR TO MINOR,2008,256,4,252
LIQUOR LAW VIOLATION,SELL/GIVE/DEL LIQUOR TO MINOR,2009,278,0,278
LIQUOR LAW VIOLATION,SELL/GIVE/DEL LIQUOR TO MINOR,2010,419,0,419
LIQUOR LAW VIOLATION,SELL/GIVE/DEL LIQUOR TO MINOR,2011,156,1,155
LIQUOR LAW VIOLATION,SELL/GIVE/DEL LIQUOR TO MINOR,2012,150,4,146
LIQUOR LAW VIOLATION,SELL/GIVE/DEL LIQUOR TO MINOR,2013,94,6,88
LIQUOR LAW VIOLATION,SELL/GIVE/DEL LIQUOR TO MINOR,2014,77,4,73
LIQUOR LAW VIOLATION,SELL/GIVE/DEL LIQUOR TO MINOR,2015,53,0,53
LIQUOR LAW VIOLATION,SELL/GIVE/DEL LIQUOR TO MINOR,2016,14,0,14
LIQUOR LAW VIOLATION,SELL/GIVE/DEL LIQUOR TO MINOR,2017,44,0,44
LIQUOR LAW VIOLATION,SELL/GIVE/DEL LIQUOR TO MINOR,2018,122,0,122
MOTOR VEHICLE THEFT,ATT: AUTOMOBILE,2008,1088,1020,68
MOTOR VEHICLE THEFT,ATT: AUTOMOBILE,2009,892,834,58
MOTOR VEHICLE THEFT,ATT: AUTOMOBILE,2010,909,858,51
MOTOR VEHICLE THEFT,ATT: AUTOMOBILE,2011,457,435,22
MOTOR VEHICLE THEFT,ATT: AUTOMOBILE,2012,551,529,22
MOTOR VEHICLE THEFT,ATT: AUTOMOBILE,2013,469,450,19
MOTOR VEHICLE THEFT,ATT: AUTOMOBILE,2014,448,428,20
MOTOR VEHICLE THEFT,ATT: AUTOMOBILE,2015,487,464,23
MOTOR VEHICLE THEFT,ATT: AUTOMOBILE,2016,508,485,23
MOTOR VEHICLE THEFT,ATT: AUTOMOBILE,2017,467,452,15
MOTOR VEHICLE THEFT,ATT: AUTOMOBILE,2018,243,241,2
MOTOR VEHICLE THEFT,"ATT: TRUCK, BUS, MOTOR HOME",2008,240,228,12
MOTOR VEHICLE THEFT,"ATT: TRUCK, BUS, MOTOR HOME",2009,134,128,6
MOTOR VEHICLE THEFT,"ATT: TRUCK, BUS, MOTOR HOME",2011,96,93,3
MOTOR VEHICLE THEFT,"ATT: TRUCK, BUS, MOTOR HOME",2012,24,22,2
MOTOR VEHICLE THEFT,"ATT: TRUCK, BUS, MOTOR HOME",2016,4,3,1
MOTOR VEHICLE THEFT,"ATTEMPT: CYCLE, SCOOTER, BIKE W-VIN",2009,10,8,2
MOTOR VEHICLE THEFT,"ATTEMPT: CYCLE, SCOOTER, BIKE W-VIN",2010,14,12,2
MOTOR VEHICLE THEFT,"ATTEMPT: CYCLE, SCOOTER, BIKE W-VIN",2012,9,6,3
MOTOR VEHICLE THEFT,"ATTEMPT: CYCLE, SCOOTER, BIKE W-VIN",2013,3,2,1
MOTOR VEHICLE THEFT,"ATTEMPT: CYCLE, SCOOTER, BIKE W-VIN",2017,4,3,1
MOTOR VEHICLE THEFT,AUTOMOBILE,2008,28579,26555,2024
MOTOR VEHICLE THEFT,AUTOMOBILE,2009,24126,22452,1674
MOTOR VEHICLE THEFT,AUTOMOBILE,2010,28731,27421,1310
MOTOR VEHICLE THEFT,AUTOMOBILE,2011,15690,15056,634
MOTOR VEHICLE THEFT,AUTOMOBILE,2012,14129,13567,562
MOTOR VEHICLE THEFT,AUTOMOBILE,2013,10616,10062,554
MOTOR VEHICLE THEFT,AUTOMOBILE,2014,8177,7661,516
MOTOR VEHICLE THEFT,AUTOMOBILE,2015,8416,7711,705
MOTOR VEHICLE THEFT,AUTOMOBILE,2016,9287,8643,644
MOTOR VEHICLE THEFT,AUTOMOBILE,2017,9827,9096,731
MOTOR VEHICLE THEFT,AUTOMOBILE,2018,8186,7815,371
MOTOR VEHICLE THEFT,"CYCLE, SCOOTER, BIKE NO VIN",2010,37,35,2
MOTOR VEHICLE THEFT,"CYCLE, SCOOTER, BIKE NO VIN",2011,16,15,1
MOTOR VEHICLE THEFT,"CYCLE, SCOOTER, BIKE NO VIN",2012,15,12,3
MOTOR VEHICLE THEFT,"CYCLE, SCOOTER, BIKE NO VIN",2015,12,11,1
MOTOR VEHICLE THEFT,"CYCLE, SCOOTER, BIKE NO VIN",2018,6,5,1
MOTOR VEHICLE THEFT,"CYCLE, SCOOTER, BIKE W-VIN",2008,760,712,48
MOTOR VEHICLE THEFT,"CYCLE, SCOOTER, BIKE W-VIN",2009,780,700,80
MOTOR VEHICLE THEFT,"CYCLE, SCOOTER, BIKE W-VIN",2010,601,545,56
MOTOR VEHICLE THEFT,"CYCLE, SCOOTER, BIKE W-VIN",2011,315,287,28
MOTOR VEHICLE THEFT,"CYCLE, SCOOTER, BIKE W-VIN",2012,344,312,32
MOTOR VEHICLE THEFT,"CYCLE, SCOOTER, BIKE W-VIN",2013,265,246,19
MOTOR VEHICLE THEFT,"CYCLE, SCOOTER, BIKE W-VIN",2014,230,222,8
MOTOR VEHICLE THEFT,"CYCLE, SCOOTER, BIKE W-VIN",2015,203,197,6
MOTOR VEHICLE THEFT,"CYCLE, SCOOTER, BIKE W-VIN",2016,220,215,5
MOTOR VEHICLE THEFT,"CYCLE, SCOOTER, BIKE W-VIN",2017,150,149,1
MOTOR VEHICLE THEFT,"CYCLE, SCOOTER, BIKE W-VIN",2018,183,180,3
MOTOR VEHICLE THEFT,THEFT/RECOVERY: AUTOMOBILE,2008,2066,1524,542
MOTOR VEHICLE THEFT,THEFT/RECOVERY: AUTOMOBILE,2009,2098,1532,566
MOTOR VEHICLE THEFT,THEFT/RECOVERY: AUTOMOBILE,2010,1697,1283,414
MOTOR VEHICLE THEFT,THEFT/RECOVERY: AUTOMOBILE,2011,788,600,188
MOTOR VEHICLE THEFT,THEFT/RECOVERY: AUTOMOBILE,2012,825,610,215
MOTOR VEHICLE THEFT,THEFT/RECOVERY: AUTOMOBILE,2013,718,517,201
MOTOR VEHICLE THEFT,THEFT/RECOVERY: AUTOMOBILE,2014,634,467,167
MOTOR VEHICLE THEFT,THEFT/RECOVERY: AUTOMOBILE,2015,620,457,163
MOTOR VEHICLE THEFT,THEFT/RECOVERY: AUTOMOBILE,2016,698,530,168
MOTOR VEHICLE THEFT,THEFT/RECOVERY: AUTOMOBILE,2017,700,548,152
MOTOR VEHICLE THEFT,THEFT/RECOVERY: AUTOMOBILE,2018,488,400,88
MOTOR VEHICLE THEFT,"THEFT/RECOVERY: CYCLE, SCOOTER, BIKE NO VIN",2010,4,2,2
MOTOR VEHICLE THEFT,"THEFT/RECOVERY: CYCLE, SCOOTER, BIKE NO VIN",2017,1,0,1
MOTOR VEHICLE THEFT,"THEFT/RECOVERY: CYCLE, SCOOTER, BIKE W-VIN",2008,28,20,8
MOTOR VEHICLE THEFT,"THEFT/RECOVERY: CYCLE, SCOOTER, BIKE W-VIN",2009,28,18,10
MOTOR VEHICLE THEFT,"THEFT/RECOVERY: CYCLE, SCOOTER, BIKE W-VIN",2010,28,14,14
MOTOR VEHICLE THEFT,"THEFT/RECOVERY: CYCLE, SCOOTER, BIKE W-VIN",2011,15,9,6
MOTOR VEHICLE THEFT,"THEFT/RECOVERY: CYCLE, SCOOTER, BIKE W-VIN",2012,16,9,7
MOTOR VEHICLE THEFT,"THEFT/RECOVERY: CYCLE, SCOOTER, BIKE W-VIN",2013,6,2,4
MOTOR VEHICLE THEFT,"THEFT/RECOVERY: CYCLE, SCOOTER, BIKE W-VIN",2014,8,3,5
MOTOR VEHICLE THEFT,"THEFT/RECOVERY: CYCLE, SCOOTER, BIKE W-VIN",2015,8,4,4
MOTOR VEHICLE THEFT,"THEFT/RECOVERY: CYCLE, SCOOTER, BIKE W-VIN",2016,6,1,5
MOTOR VEHICLE THEFT,"THEFT/RECOVERY: CYCLE, SCOOTER, BIKE W-VIN",2017,6,3,3
MOTOR VEHICLE THEFT,"THEFT/RECOVERY: CYCLE, SCOOTER, BIKE W-VIN",2018,4,3,1
MOTOR VEHICLE THEFT,"THEFT/RECOVERY: TRUCK,BUS,MHOME",2008,358,266,92
MOTOR VEHICLE THEFT,"THEFT/RECOVERY: TRUCK,BUS,MHOME",2009,192,150,42
MOTOR VEHICLE THEFT,"THEFT/RECOVERY: TRUCK,BUS,MHOME",2010,166,134,32
MOTOR VEHICLE THEFT,"THEFT/RECOVERY: TRUCK,BUS,MHOME",2011,122,97,25
MOTOR VEHICLE THEFT,"THEFT/RECOVERY: TRUCK,BUS,MHOME",2012,23,17,6
MOTOR VEHICLE THEFT,"THEFT/RECOVERY: TRUCK,BUS,MHOME",2013,34,23,11
MOTOR VEHICLE THEFT,"THEFT/RECOVERY: TRUCK,BUS,MHOME",2014,31,30,1
MOTOR VEHICLE THEFT,"THEFT/RECOVERY: TRUCK,BUS,MHOME",2015,33,30,3
MOTOR VEHICLE THEFT,"THEFT/RECOVERY: TRUCK,BUS,MHOME",2016,30,24,6
MOTOR VEHICLE THEFT,"THEFT/RECOVERY: TRUCK,BUS,MHOME",2017,24,22,2
MOTOR VEHICLE THEFT,"THEFT/RECOVERY: TRUCK,BUS,MHOME",2018,20,17,3
MOTOR VEHICLE THEFT,"TRUCK, BUS, MOTOR HOME",2008,4096,3858,238
MOTOR VEHICLE THEFT,"TRUCK, BUS, MOTOR HOME",2009,2344,2196,148
MOTOR VEHICLE THEFT,"TRUCK, BUS, MOTOR HOME",2010,2950,2874,76
MOTOR VEHICLE THEFT,"TRUCK, BUS, MOTOR HOME",2011,1877,1838,39
MOTOR VEHICLE THEFT,"TRUCK, BUS, MOTOR HOME",2012,545,529,16
MOTOR VEHICLE THEFT,"TRUCK, BUS, MOTOR HOME",2013,400,383,17
MOTOR VEHICLE THEFT,"TRUCK, BUS, MOTOR HOME",2014,254,243,11
MOTOR VEHICLE THEFT,"TRUCK, BUS, MOTOR HOME",2015,247,234,13
MOTOR VEHICLE THEFT,"TRUCK, BUS, MOTOR HOME",2016,238,231,7
MOTOR VEHICLE THEFT,"TRUCK, BUS, MOTOR HOME",2017,180,174,6
MOTOR VEHICLE THEFT,"TRUCK, BUS, MOTOR HOME",2018,168,165,3
NARCOTICS,ALTER/FORGE PRESCRIPTION,2008,114,14,100
NARCOTICS,ALTER/FORGE PRESCRIPTION,2009,114,2,112
NARCOTICS,ALTER/FORGE PRESCRIPTION,2010,88,0,88
NARCOTICS,ALTER/FORGE PRESCRIPTION,2011,35,0,35
NARCOTICS,ALTER/FORGE PRESCRIPTION,2012,32,1,31
NARCOTICS,ALTER/FORGE PRESCRIPTION,2013,48,2,46
NARCOTICS,ALTER/FORGE PRESCRIPTION,2014,66,3,63
NARCOTICS,ALTER/FORGE PRESCRIPTION,2015,62,2,60
NARCOTICS,ALTER/FORGE PRESCRIPTION,2016,67,2,65
NARCOTICS,ALTER/FORGE PRESCRIPTION,2017,74,1,73
NARCOTICS,ALTER/FORGE PRESCRIPTION,2018,64,2,62
NARCOTICS,ATTEMPT POSSESSION CANNABIS,2008,262,0,262
NARCOTICS,ATTEMPT POSSESSION CANNABIS,2009,94,2,92
NARCOTICS,ATTEMPT POSSESSION CANNABIS,2010,29,0,29
NARCOTICS,ATTEMPT POSSESSION CANNABIS,2011,7,0,7
NARCOTICS,ATTEMPT POSSESSION CANNABIS,2012,14,0,14
NARCOTICS,ATTEMPT POSSESSION CANNABIS,2013,4,0,4
NARCOTICS,ATTEMPT POSSESSION CANNABIS,2014,14,0,14
NARCOTICS,ATTEMPT POSSESSION CANNABIS,2015,1,0,1
NARCOTICS,ATTEMPT POSSESSION CANNABIS,2018,2,0,2
NARCOTICS,ATTEMPT POSSESSION NARCOTICS,2008,1542,12,1530
NARCOTICS,ATTEMPT POSSESSION NARCOTICS,2009,656,12,644
NARCOTICS,ATTEMPT POSSESSION NARCOTICS,2010,287,0,287
NARCOTICS,ATTEMPT POSSESSION NARCOTICS,2011,98,0,98
NARCOTICS,ATTEMPT POSSESSION NARCOTICS,2012,57,0,57
NARCOTICS,ATTEMPT POSSESSION NARCOTICS,2013,23,0,23
NARCOTICS,ATTEMPT POSSESSION NARCOTICS,2014,21,0,21
NARCOTICS,ATTEMPT POSSESSION NARCOTICS,2015,109,0,109
NARCOTICS,ATTEMPT POSSESSION NARCOTICS,2016,97,0,97
NARCOTICS,ATTEMPT POSSESSION NARCOTICS,2017,56,0,56
NARCOTICS,CALCULATED CANNABIS CONSPIRACY,2011,1,0,1
NARCOTICS,CALCULATED CANNABIS CONSPIRACY,2013,3,1,2
NARCOTICS,CANNABIS PLANT,2008,48,0,48
NARCOTICS,CANNABIS PLANT,2009,90,2,88
NARCOTICS,CANNABIS PLANT,2010,104,0,104
NARCOTICS,CANNABIS PLANT,2011,35,0,35
NARCOTICS,CANNABIS PLANT,2012,36,2,34
NARCOTICS,CANNABIS PLANT,2013,23,1,22
NARCOTICS,CANNABIS PLANT,2014,18,0,18
NARCOTICS,CANNABIS PLANT,2015,8,0,8
NARCOTICS,CANNABIS PLANT,2016,6,0,6
NARCOTICS,CANNABIS PLANT,2017,4,0,4
NARCOTICS,CANNABIS PLANT,2018,2,0,2
NARCOTICS,CONT SUBS:FAIL TO MAINT RECORD,2008,6,0,6
NARCOTICS,CONT SUBS:FAIL TO MAINT RECORD,2009,4,0,4
NARCOTICS,CONT SUBS:FAIL TO MAINT RECORD,2010,2,0,2
NARCOTICS,CONT SUBS:FAIL TO MAINT RECORD,2011,1,0,1
NARCOTICS,CONT SUBS:FAIL TO MAINT RECORD,2012,2,0,2
NARCOTICS,CONT SUBS:FAIL TO MAINT RECORD,2013,3,0,3
NARCOTICS,CONT SUBS:FAIL TO MAINT RECORD,2014,4,0,4
NARCOTICS,CONT SUBS:FAIL TO MAINT RECORD,2015,6,0,6
NARCOTICS,CONT SUBS:FAIL TO MAINT RECORD,2016,3,0,3
NARCOTICS,CRIMINAL DRUG CONSPIRACY,2008,50,4,46
NARCOTICS,CRIMINAL DRUG CONSPIRACY,2009,58,0,58
NARCOTICS,CRIMINAL DRUG CONSPIRACY,2010,76,3,73
NARCOTICS,CRIMINAL DRUG CONSPIRACY,2011,63,2,61
NARCOTICS,CRIMINAL DRUG CONSPIRACY,2012,55,5,50
NARCOTICS,CRIMINAL DRUG CONSPIRACY,2013,66,6,60
NARCOTICS,CRIMINAL DRUG CONSPIRACY,2014,30,4,26
NARCOTICS,CRIMINAL DRUG CONSPIRACY,2015,25,0,25
NARCOTICS,CRIMINAL DRUG CONSPIRACY,2016,2,0,2
NARCOTICS,CRIMINAL DRUG CONSPIRACY,2017,18,0,18
NARCOTICS,CRIMINAL DRUG CONSPIRACY,2018,8,0,8
NARCOTICS,DEL CONT SUBS TO PERSON <18,2008,8,0,8
NARCOTICS,DEL CONT SUBS TO PERSON <18,2009,8,0,8
NARCOTICS,DEL CONT SUBS TO PERSON <18,2010,8,0,8
NARCOTICS,DEL CONT SUBS TO PERSON <18,2011,3,0,3
NARCOTICS,DEL CONT SUBS TO PERSON <18,2013,4,0,4
NARCOTICS,DEL CONT SUBS TO PERSON <18,2014,1,0,1
NARCOTICS,DEL CONT SUBS TO PERSON <18,2015,1,0,1
NARCOTICS,DEL CONT SUBS TO PERSON <18,2016,4,0,4
NARCOTICS,DEL CONT SUBS TO PERSON <18,2017,2,0,2
NARCOTICS,DEL CONT SUBS TO PERSON <18,2018,1,0,1
NARCOTICS,DELIVER CANNABIS TO PERSON <18,2008,4,0,4
NARCOTICS,DELIVER CANNABIS TO PERSON <18,2009,12,0,12
NARCOTICS,DELIVER CANNABIS TO PERSON <18,2010,4,0,4
NARCOTICS,DELIVER CANNABIS TO PERSON <18,2011,3,0,3
NARCOTICS,DELIVER CANNABIS TO PERSON <18,2012,1,0,1
NARCOTICS,DELIVER CANNABIS TO PERSON <18,2013,4,1,3
NARCOTICS,DELIVER CANNABIS TO PERSON <18,2014,3,0,3
NARCOTICS,DELIVER CANNABIS TO PERSON <18,2016,4,0,4
NARCOTICS,DELIVER CANNABIS TO PERSON <18,2017,4,0,4
NARCOTICS,DELIVER CANNABIS TO PERSON <18,2018,1,0,1
NARCOTICS,FAIL REGISTER LIC:CONT SUBS,2016,1,0,1
NARCOTICS,FORFEIT PROPERTY,2008,408,10,398
NARCOTICS,FORFEIT PROPERTY,2009,452,10,442
NARCOTICS,FORFEIT PROPERTY,2010,397,0,397
NARCOTICS,FORFEIT PROPERTY,2011,178,3,175
NARCOTICS,FORFEIT PROPERTY,2012,206,6,200
NARCOTICS,FORFEIT PROPERTY,2013,197,16,181
NARCOTICS,FORFEIT PROPERTY,2014,156,5,151
NARCOTICS,FORFEIT PROPERTY,2015,123,0,123
NARCOTICS,FORFEIT PROPERTY,2016,28,0,28
NARCOTICS,FORFEIT PROPERTY,2017,94,0,94
NARCOTICS,FORFEIT PROPERTY,2018,67,0,67
NARCOTICS,FOUND SUSPECT NARCOTICS,2008,2154,56,2098
NARCOTICS,FOUND SUSPECT NARCOTICS,2009,1846,22,1824
NARCOTICS,FOUND SUSPECT NARCOTICS,2010,1904,11,1893
NARCOTICS,FOUND SUSPECT NARCOTICS,2011,934,3,931
NARCOTICS,FOUND SUSPECT NARCOTICS,2012,950,19,931
NARCOTICS,FOUND SUSPECT NARCOTICS,2013,774,26,748
NARCOTICS,FOUND SUSPECT NARCOTICS,2014,669,11,658
NARCOTICS,FOUND SUSPECT NARCOTICS,2015,598,0,598
NARCOTICS,FOUND SUSPECT NARCOTICS,2016,643,0,643
NARCOTICS,FOUND SUSPECT NARCOTICS,2017,973,1,972
NARCOTICS,FOUND SUSPECT NARCOTICS,2018,919,0,919
NARCOTICS,MANU/DEL:CANNABIS 10GM OR LESS,2008,1010,10,1000
NARCOTICS,MANU/DEL:CANNABIS 10GM OR LESS,2009,930,0,930
NARCOTICS,MANU/DEL:CANNABIS 10GM OR LESS,2010,1194,4,1190
NARCOTICS,MANU/DEL:CANNABIS 10GM OR LESS,2011,556,1,555
NARCOTICS,MANU/DEL:CANNABIS 10GM OR LESS,2012,652,16,636
NARCOTICS,MANU/DEL:CANNABIS 10GM OR LESS,2013,936,32,904
NARCOTICS,MANU/DEL:CANNABIS 10GM OR LESS,2014,756,4,752
NARCOTICS,MANU/DEL:CANNABIS 10GM OR LESS,2015,610,0,610
NARCOTICS,MANU/DEL:CANNABIS 10GM OR LESS,2016,363,0,363
NARCOTICS,MANU/DEL:CANNABIS 10GM OR LESS,2017,657,0,657
NARCOTICS,MANU/DEL:CANNABIS 10GM OR LESS,2018,619,0,619
NARCOTICS,MANU/DEL:CANNABIS OVER 10 GMS,2008,1004,8,996
NARCOTICS,MANU/DEL:CANNABIS OVER 10 GMS,2009,990,6,984
NARCOTICS,MANU/DEL:CANNABIS OVER 10 GMS,2010,1082,1,1081
NARCOTICS,MANU/DEL:CANNABIS OVER 10 GMS,2011,402,1,401
NARCOTICS,MANU/DEL:CANNABIS OVER 10 GMS,2012,445,8,437
NARCOTICS,MANU/DEL:CANNABIS OVER 10 GMS,2013,448,12,436
NARCOTICS,MANU/DEL:CANNABIS OVER 10 GMS,2014,384,2,382
NARCOTICS,MANU/DEL:CANNABIS OVER 10 GMS,2015,363,0,363
NARCOTICS,MANU/DEL:CANNABIS OVER 10 GMS,2016,272,0,272
NARCOTICS,MANU/DEL:CANNABIS OVER 10 GMS,2017,609,0,609
NARCOTICS,MANU/DEL:CANNABIS OVER 10 GMS,2018,1033,0,1033
NARCOTICS,MANU/DELIVER: HALLUCINOGEN,2008,122,6,116
NARCOTICS,MANU/DELIVER: HALLUCINOGEN,2009,120,0,120
NARCOTICS,MANU/DELIVER: HALLUCINOGEN,2010,122,0,122
NARCOTICS,MANU/DELIVER: HALLUCINOGEN,2011,27,0,27
NARCOTICS,MANU/DELIVER: HALLUCINOGEN,2012,32,2,30
NARCOTICS,MANU/DELIVER: HALLUCINOGEN,2013,38,4,34
NARCOTICS,MANU/DELIVER: HALLUCINOGEN,2014,31,0,31
NARCOTICS,MANU/DELIVER: HALLUCINOGEN,2015,27,0,27
NARCOTICS,MANU/DELIVER: HALLUCINOGEN,2016,12,0,12
NARCOTICS,MANU/DELIVER: HALLUCINOGEN,2017,16,0,16
NARCOTICS,MANU/DELIVER: HALLUCINOGEN,2018,9,0,9
NARCOTICS,MANU/DELIVER: HEROIN (WHITE),2008,2138,26,2112
NARCOTICS,MANU/DELIVER: HEROIN (WHITE),2009,1924,12,1912
NARCOTICS,MANU/DELIVER: HEROIN (WHITE),2010,2434,6,2428
NARCOTICS,MANU/DELIVER: HEROIN (WHITE),2011,1008,4,1004
NARCOTICS,MANU/DELIVER: HEROIN (WHITE),2012,1388,50,1338
NARCOTICS,MANU/DELIVER: HEROIN (WHITE),2013,2137,103,2034
NARCOTICS,MANU/DELIVER: HEROIN (WHITE),2014,1635,30,1605
NARCOTICS,MANU/DELIVER: HEROIN (WHITE),2015,1191,1,1190
NARCOTICS,MANU/DELIVER: HEROIN (WHITE),2016,488,0,488
NARCOTICS,MANU/DELIVER: HEROIN (WHITE),2017,1064,0,1064
NARCOTICS,MANU/DELIVER: HEROIN (WHITE),2018,892,1,891
NARCOTICS,MANU/DELIVER: HEROIN(BRN/TAN),2008,58,0,58
NARCOTICS,MANU/DELIVER: HEROIN(BRN/TAN),2009,46,0,46
NARCOTICS,MANU/DELIVER: HEROIN(BRN/TAN),2010,111,2,109
NARCOTICS,MANU/DELIVER: HEROIN(BRN/TAN),2011,43,0,43
NARCOTICS,MANU/DELIVER: HEROIN(BRN/TAN),2012,29,2,27
NARCOTICS,MANU/DELIVER: HEROIN(BRN/TAN),2013,51,0,51
NARCOTICS,MANU/DELIVER: HEROIN(BRN/TAN),2014,36,1,35
NARCOTICS,MANU/DELIVER: HEROIN(BRN/TAN),2015,26,0,26
NARCOTICS,MANU/DELIVER: HEROIN(BRN/TAN),2016,19,0,19
NARCOTICS,MANU/DELIVER: HEROIN(BRN/TAN),2017,20,0,20
NARCOTICS,MANU/DELIVER: HEROIN(BRN/TAN),2018,27,0,27
NARCOTICS,MANU/DELIVER: METHAMPHETAMINES,2010,3,0,3
NARCOTICS,MANU/DELIVER: METHAMPHETAMINES,2011,9,0,9
NARCOTICS,MANU/DELIVER: METHAMPHETAMINES,2012,6,0,6
NARCOTICS,MANU/DELIVER: METHAMPHETAMINES,2013,5,1,4
NARCOTICS,MANU/DELIVER: METHAMPHETAMINES,2014,4,0,4
NARCOTICS,MANU/DELIVER: METHAMPHETAMINES,2015,7,0,7
NARCOTICS,MANU/DELIVER: METHAMPHETAMINES,2016,5,0,5
NARCOTICS,MANU/DELIVER: METHAMPHETAMINES,2017,10,0,10
NARCOTICS,MANU/DELIVER: METHAMPHETAMINES,2018,6,0,6
NARCOTICS,MANU/DELIVER:AMPHETAMINES,2008,14,2,12
NARCOTICS,MANU/DELIVER:AMPHETAMINES,2009,4,0,4
NARCOTICS,MANU/DELIVER:AMPHETAMINES,2010,17,0,17
NARCOTICS,MANU/DELIVER:AMPHETAMINES,2011,9,0,9
NARCOTICS,MANU/DELIVER:AMPHETAMINES,2012,1,0,1
NARCOTICS,MANU/DELIVER:AMPHETAMINES,2013,8,0,8
NARCOTICS,MANU/DELIVER:AMPHETAMINES,2014,3,0,3
NARCOTICS,MANU/DELIVER:AMPHETAMINES,2015,2,0,2
NARCOTICS,MANU/DELIVER:AMPHETAMINES,2016,4,0,4
NARCOTICS,MANU/DELIVER:AMPHETAMINES,2017,2,0,2
NARCOTICS,MANU/DELIVER:BARBITUATES,2008,20,0,20
NARCOTICS,MANU/DELIVER:BARBITUATES,2009,16,0,16
NARCOTICS,MANU/DELIVER:BARBITUATES,2010,27,0,27
NARCOTICS,MANU/DELIVER:BARBITUATES,2011,11,0,11
NARCOTICS,MANU/DELIVER:BARBITUATES,2012,15,0,15
NARCOTICS,MANU/DELIVER:BARBITUATES,2013,20,1,19
NARCOTICS,MANU/DELIVER:BARBITUATES,2014,17,0,17
NARCOTICS,MANU/DELIVER:BARBITUATES,2015,19,0,19
NARCOTICS,MANU/DELIVER:BARBITUATES,2016,8,0,8
NARCOTICS,MANU/DELIVER:BARBITUATES,2017,14,0,14
NARCOTICS,MANU/DELIVER:BARBITUATES,2018,18,0,18
NARCOTICS,MANU/DELIVER:COCAINE,2008,338,10,328
NARCOTICS,MANU/DELIVER:COCAINE,2009,394,4,390
NARCOTICS,MANU/DELIVER:COCAINE,2010,460,2,458
NARCOTICS,MANU/DELIVER:COCAINE,2011,131,1,130
NARCOTICS,MANU/DELIVER:COCAINE,2012,103,0,103
NARCOTICS,MANU/DELIVER:COCAINE,2013,84,2,82
NARCOTICS,MANU/DELIVER:COCAINE,2014,69,0,69
NARCOTICS,MANU/DELIVER:COCAINE,2015,57,0,57
NARCOTICS,MANU/DELIVER:COCAINE,2016,20,0,20
NARCOTICS,MANU/DELIVER:COCAINE,2017,79,0,79
NARCOTICS,MANU/DELIVER:COCAINE,2018,47,0,47
NARCOTICS,MANU/DELIVER:CRACK,2008,2346,30,2316
NARCOTICS,MANU/DELIVER:CRACK,2009,2004,6,1998
NARCOTICS,MANU/DELIVER:CRACK,2010,1897,1,1896
NARCOTICS,MANU/DELIVER:CRACK,2011,620,1,619
NARCOTICS,MANU/DELIVER:CRACK,2012,506,14,492
NARCOTICS,MANU/DELIVER:CRACK,2013,622,33,589
NARCOTICS,MANU/DELIVER:CRACK,2014,451,8,443
NARCOTICS,MANU/DELIVER:CRACK,2015,443,0,443
NARCOTICS,MANU/DELIVER:CRACK,2016,137,0,137
NARCOTICS,MANU/DELIVER:CRACK,2017,490,0,490
NARCOTICS,MANU/DELIVER:CRACK,2018,420,0,420
NARCOTICS,MANU/DELIVER:HEROIN(BLACK TAR),2008,2,0,2
NARCOTICS,MANU/DELIVER:HEROIN(BLACK TAR),2009,2,0,2
NARCOTICS,MANU/DELIVER:HEROIN(BLACK TAR),2010,2,0,2
NARCOTICS,MANU/DELIVER:HEROIN(BLACK TAR),2011,1,0,1
NARCOTICS,MANU/DELIVER:HEROIN(BLACK TAR),2012,1,0,1
NARCOTICS,MANU/DELIVER:HEROIN(BLACK TAR),2013,3,1,2
NARCOTICS,MANU/DELIVER:HEROIN(BLACK TAR),2014,1,0,1
NARCOTICS,MANU/DELIVER:HEROIN(BLACK TAR),2015,1,0,1
NARCOTICS,MANU/DELIVER:HEROIN(BLACK TAR),2017,1,0,1
NARCOTICS,MANU/DELIVER:HEROIN(BLACK TAR),2018,1,0,1
NARCOTICS,MANU/DELIVER:LOOK-ALIKE DRUG,2008,4,0,4
NARCOTICS,MANU/DELIVER:LOOK-ALIKE DRUG,2009,8,0,8
NARCOTICS,MANU/DELIVER:LOOK-ALIKE DRUG,2010,5,0,5
NARCOTICS,MANU/DELIVER:LOOK-ALIKE DRUG,2011,6,0,6
NARCOTICS,MANU/DELIVER:LOOK-ALIKE DRUG,2012,7,0,7
NARCOTICS,MANU/DELIVER:LOOK-ALIKE DRUG,2013,2,0,2
NARCOTICS,MANU/DELIVER:LOOK-ALIKE DRUG,2014,6,0,6
NARCOTICS,MANU/DELIVER:LOOK-ALIKE DRUG,2015,2,0,2
NARCOTICS,MANU/DELIVER:PCP,2008,8,0,8
NARCOTICS,MANU/DELIVER:PCP,2009,14,0,14
NARCOTICS,MANU/DELIVER:PCP,2010,16,0,16
NARCOTICS,MANU/DELIVER:PCP,2011,17,0,17
NARCOTICS,MANU/DELIVER:PCP,2012,24,2,22
NARCOTICS,MANU/DELIVER:PCP,2013,45,1,44
NARCOTICS,MANU/DELIVER:PCP,2014,45,2,43
NARCOTICS,MANU/DELIVER:PCP,2015,40,0,40
NARCOTICS,MANU/DELIVER:PCP,2016,15,0,15
NARCOTICS,MANU/DELIVER:PCP,2017,55,0,55
NARCOTICS,MANU/DELIVER:PCP,2018,37,0,37
NARCOTICS,MANU/DELIVER:SYNTHETIC DRUGS,2008,12,0,12
NARCOTICS,MANU/DELIVER:SYNTHETIC DRUGS,2009,26,0,26
NARCOTICS,MANU/DELIVER:SYNTHETIC DRUGS,2010,26,0,26
NARCOTICS,MANU/DELIVER:SYNTHETIC DRUGS,2011,19,0,19
NARCOTICS,MANU/DELIVER:SYNTHETIC DRUGS,2012,18,1,17
NARCOTICS,MANU/DELIVER:SYNTHETIC DRUGS,2013,37,4,33
NARCOTICS,MANU/DELIVER:SYNTHETIC DRUGS,2014,62,2,60
NARCOTICS,MANU/DELIVER:SYNTHETIC DRUGS,2015,56,0,56
NARCOTICS,MANU/DELIVER:SYNTHETIC DRUGS,2016,14,0,14
NARCOTICS,MANU/DELIVER:SYNTHETIC DRUGS,2017,28,0,28
NARCOTICS,MANU/DELIVER:SYNTHETIC DRUGS,2018,36,0,36
NARCOTICS,MANU/POSS. W/INTENT TO DELIVER: SYNTHETIC MARIJUANA,2012,3,0,3
NARCOTICS,MANU/POSS. W/INTENT TO DELIVER: SYNTHETIC MARIJUANA,2013,2,0,2
NARCOTICS,MANU/POSS. W/INTENT TO DELIVER: SYNTHETIC MARIJUANA,2014,3,0,3
NARCOTICS,MANU/POSS. W/INTENT TO DELIVER: SYNTHETIC MARIJUANA,2015,4,0,4
NARCOTICS,MANU/POSS. W/INTENT TO DELIVER: SYNTHETIC MARIJUANA,2016,2,0,2
NARCOTICS,MANU/POSS. W/INTENT TO DELIVER: SYNTHETIC MARIJUANA,2017,5,0,5
NARCOTICS,MANU/POSS. W/INTENT TO DELIVER: SYNTHETIC MARIJUANA,2018,5,0,5
NARCOTICS,POS: HYPODERMIC NEEDLE,2008,62,2,60
NARCOTICS,POS: HYPODERMIC NEEDLE,2009,64,2,62
NARCOTICS,POS: HYPODERMIC NEEDLE,2010,48,0,48
NARCOTICS,POS: HYPODERMIC NEEDLE,2011,20,0,20
NARCOTICS,POS: HYPODERMIC NEEDLE,2012,32,0,32
NARCOTICS,POS: HYPODERMIC NEEDLE,2013,25,0,25
NARCOTICS,POS: HYPODERMIC NEEDLE,2014,27,0,27
NARCOTICS,POS: HYPODERMIC NEEDLE,2015,17,0,17
NARCOTICS,POS: HYPODERMIC NEEDLE,2016,15,0,15
NARCOTICS,POS: HYPODERMIC NEEDLE,2017,11,0,11
NARCOTICS,POS: HYPODERMIC NEEDLE,2018,8,0,8
NARCOTICS,POSS: AMPHETAMINES,2008,46,4,42
NARCOTICS,POSS: AMPHETAMINES,2009,46,0,46
NARCOTICS,POSS: AMPHETAMINES,2010,80,0,80
NARCOTICS,POSS: AMPHETAMINES,2011,41,0,41
NARCOTICS,POSS: AMPHETAMINES,2012,39,1,38
NARCOTICS,POSS: AMPHETAMINES,2013,36,0,36
NARCOTICS,POSS: AMPHETAMINES,2014,32,0,32
NARCOTICS,POSS: AMPHETAMINES,2015,47,0,47
NARCOTICS,POSS: AMPHETAMINES,2016,22,0,22
NARCOTICS,POSS: AMPHETAMINES,2017,25,0,25
NARCOTICS,POSS: AMPHETAMINES,2018,37,0,37
NARCOTICS,POSS: BARBITUATES,2008,80,2,78
NARCOTICS,POSS: BARBITUATES,2009,108,0,108
NARCOTICS,POSS: BARBITUATES,2010,142,2,140
NARCOTICS,POSS: BARBITUATES,2011,96,0,96
NARCOTICS,POSS: BARBITUATES,2012,117,0,117
NARCOTICS,POSS: BARBITUATES,2013,116,1,115
NARCOTICS,POSS: BARBITUATES,2014,130,0,130
NARCOTICS,POSS: BARBITUATES,2015,189,0,189
NARCOTICS,POSS: BARBITUATES,2016,109,0,109
NARCOTICS,POSS: BARBITUATES,2017,182,0,182
NARCOTICS,POSS: BARBITUATES,2018,153,0,153
NARCOTICS,POSS: CANNABIS 30GMS OR LESS,2008,41166,752,40414
NARCOTICS,POSS: CANNABIS 30GMS OR LESS,2009,42068,222,41846
NARCOTICS,POSS: CANNABIS 30GMS OR LESS,2010,42052,81,41971
NARCOTICS,POSS: CANNABIS 30GMS OR LESS,2011,20106,18,20088
NARCOTICS,POSS: CANNABIS 30GMS OR LESS,2012,17734,48,17686
NARCOTICS,POSS: CANNABIS 30GMS OR LESS,2013,15971,42,15929
NARCOTICS,POSS: CANNABIS 30GMS OR LESS,2014,12824,15,12809
NARCOTICS,POSS: CANNABIS 30GMS OR LESS,2015,9826,2,9824
NARCOTICS,POSS: CANNABIS 30GMS OR LESS,2016,3918,2,3916
NARCOTICS,POSS: CANNABIS 30GMS OR LESS,2017,1211,1,1210
NARCOTICS,POSS: CANNABIS 30GMS OR LESS,2018,1295,1,1294
NARCOTICS,POSS: CANNABIS MORE THAN 30GMS,2008,1410,22,1388
NARCOTICS,POSS: CANNABIS MORE THAN 30GMS,2009,1912,16,1896
NARCOTICS,POSS: CANNABIS MORE THAN 30GMS,2010,2402,9,2393
NARCOTICS,POSS: CANNABIS MORE THAN 30GMS,2011,1186,5,1181
NARCOTICS,POSS: CANNABIS MORE THAN 30GMS,2012,1116,22,1094
NARCOTICS,POSS: CANNABIS MORE THAN 30GMS,2013,1012,55,957
NARCOTICS,POSS: CANNABIS MORE THAN 30GMS,2014,855,15,840
NARCOTICS,POSS: CANNABIS MORE THAN 30GMS,2015,714,0,714
NARCOTICS,POSS: CANNABIS MORE THAN 30GMS,2016,328,0,328
NARCOTICS,POSS: CANNABIS MORE THAN 30GMS,2017,701,2,699
NARCOTICS,POSS: CANNABIS MORE THAN 30GMS,2018,816,0,816
NARCOTICS,POSS: COCAINE,2008,3768,42,3726
NARCOTICS,POSS: COCAINE,2009,3154,14,3140
NARCOTICS,POSS: COCAINE,2010,2860,10,2850
NARCOTICS,POSS: COCAINE,2011,1308,1,1307
NARCOTICS,POSS: COCAINE,2012,1133,18,1115
NARCOTICS,POSS: COCAINE,2013,905,18,887
NARCOTICS,POSS: COCAINE,2014,915,4,911
NARCOTICS,POSS: COCAINE,2015,789,0,789
NARCOTICS,POSS: COCAINE,2016,374,0,374
NARCOTICS,POSS: COCAINE,2017,530,0,530
NARCOTICS,POSS: COCAINE,2018,514,0,514
NARCOTICS,POSS: CRACK,2008,14800,280,14520
NARCOTICS,POSS: CRACK,2009,11212,74,11138
NARCOTICS,POSS: CRACK,2010,9578,17,9561
NARCOTICS,POSS: CRACK,2011,4268,5,4263
NARCOTICS,POSS: CRACK,2012,3263,12,3251
NARCOTICS,POSS: CRACK,2013,2656,44,2612
NARCOTICS,POSS: CRACK,2014,2267,7,2260
NARCOTICS,POSS: CRACK,2015,1989,1,1988
NARCOTICS,POSS: CRACK,2016,806,0,806
NARCOTICS,POSS: CRACK,2017,1115,0,1115
NARCOTICS,POSS: CRACK,2018,1165,0,1165
NARCOTICS,POSS: HALLUCINOGENS,2008,856,12,844
NARCOTICS,POSS: HALLUCINOGENS,2009,878,6,872
NARCOTICS,POSS: HALLUCINOGENS,2010,714,0,714
NARCOTICS,POSS: HALLUCINOGENS,2011,307,1,306
NARCOTICS,POSS: HALLUCINOGENS,2012,280,1,279
NARCOTICS,POSS: HALLUCINOGENS,2013,237,6,231
NARCOTICS,POSS: HALLUCINOGENS,2014,208,0,208
NARCOTICS,POSS: HALLUCINOGENS,2015,171,0,171
NARCOTICS,POSS: HALLUCINOGENS,2016,74,0,74
NARCOTICS,POSS: HALLUCINOGENS,2017,95,0,95
NARCOTICS,POSS: HALLUCINOGENS,2018,98,0,98
NARCOTICS,POSS: HEROIN(BLACK TAR),2008,44,0,44
NARCOTICS,POSS: HEROIN(BLACK TAR),2009,34,0,34
NARCOTICS,POSS: HEROIN(BLACK TAR),2010,26,0,26
NARCOTICS,POSS: HEROIN(BLACK TAR),2011,19,0,19
NARCOTICS,POSS: HEROIN(BLACK TAR),2012,9,0,9
NARCOTICS,POSS: HEROIN(BLACK TAR),2013,15,1,14
NARCOTICS,POSS: HEROIN(BLACK TAR),2014,9,0,9
NARCOTICS,POSS: HEROIN(BLACK TAR),2015,13,0,13
NARCOTICS,POSS: HEROIN(BLACK TAR),2016,7,0,7
NARCOTICS,POSS: HEROIN(BLACK TAR),2017,12,0,12
NARCOTICS,POSS: HEROIN(BLACK TAR),2018,9,0,9
NARCOTICS,POSS: HEROIN(BRN/TAN),2008,312,8,304
NARCOTICS,POSS: HEROIN(BRN/TAN),2009,286,4,282
NARCOTICS,POSS: HEROIN(BRN/TAN),2010,368,2,366
NARCOTICS,POSS: HEROIN(BRN/TAN),2011,216,1,215
NARCOTICS,POSS: HEROIN(BRN/TAN),2012,217,0,217
NARCOTICS,POSS: HEROIN(BRN/TAN),2013,216,4,212
NARCOTICS,POSS: HEROIN(BRN/TAN),2014,204,0,204
NARCOTICS,POSS: HEROIN(BRN/TAN),2015,155,0,155
NARCOTICS,POSS: HEROIN(BRN/TAN),2016,92,0,92
NARCOTICS,POSS: HEROIN(BRN/TAN),2017,90,0,90
NARCOTICS,POSS: HEROIN(BRN/TAN),2018,108,0,108
NARCOTICS,POSS: HEROIN(WHITE),2008,10540,248,10292
NARCOTICS,POSS: HEROIN(WHITE),2009,9956,82,9874
NARCOTICS,POSS: HEROIN(WHITE),2010,10003,9,9994
NARCOTICS,POSS: HEROIN(WHITE),2011,5041,6,5035
NARCOTICS,POSS: HEROIN(WHITE),2012,5262,27,5235
NARCOTICS,POSS: HEROIN(WHITE),2013,5389,55,5334
NARCOTICS,POSS: HEROIN(WHITE),2014,4434,29,4405
NARCOTICS,POSS: HEROIN(WHITE),2015,3664,1,3663
NARCOTICS,POSS: HEROIN(WHITE),2016,1915,2,1913
NARCOTICS,POSS: HEROIN(WHITE),2017,2221,0,2221
NARCOTICS,POSS: HEROIN(WHITE),2018,2257,1,2256
NARCOTICS,POSS: LOOK-ALIKE DRUGS,2008,34,0,34
NARCOTICS,POSS: LOOK-ALIKE DRUGS,2009,26,0,26
NARCOTICS,POSS: LOOK-ALIKE DRUGS,2010,26,0,26
NARCOTICS,POSS: LOOK-ALIKE DRUGS,2011,10,0,10
NARCOTICS,POSS: LOOK-ALIKE DRUGS,2012,8,0,8
NARCOTICS,POSS: LOOK-ALIKE DRUGS,2013,7,0,7
NARCOTICS,POSS: LOOK-ALIKE DRUGS,2014,8,0,8
NARCOTICS,POSS: LOOK-ALIKE DRUGS,2015,2,0,2
NARCOTICS,POSS: LOOK-ALIKE DRUGS,2016,3,0,3
NARCOTICS,POSS: LOOK-ALIKE DRUGS,2017,4,0,4
NARCOTICS,POSS: METHAMPHETAMINES,2008,46,4,42
NARCOTICS,POSS: METHAMPHETAMINES,2009,30,0,30
NARCOTICS,POSS: METHAMPHETAMINES,2010,47,0,47
NARCOTICS,POSS: METHAMPHETAMINES,2011,42,0,42
NARCOTICS,POSS: METHAMPHETAMINES,2012,62,2,60
NARCOTICS,POSS: METHAMPHETAMINES,2013,61,2,59
NARCOTICS,POSS: METHAMPHETAMINES,2014,36,0,36
NARCOTICS,POSS: METHAMPHETAMINES,2015,58,0,58
NARCOTICS,POSS: METHAMPHETAMINES,2016,40,0,40
NARCOTICS,POSS: METHAMPHETAMINES,2017,57,0,57
NARCOTICS,POSS: METHAMPHETAMINES,2018,66,0,66
NARCOTICS,POSS: PCP,2008,218,4,214
NARCOTICS,POSS: PCP,2009,228,0,228
NARCOTICS,POSS: PCP,2010,288,0,288
NARCOTICS,POSS: PCP,2011,176,1,175
NARCOTICS,POSS: PCP,2012,248,0,248
NARCOTICS,POSS: PCP,2013,315,0,315
NARCOTICS,POSS: PCP,2014,287,1,286
NARCOTICS,POSS: PCP,2015,262,0,262
NARCOTICS,POSS: PCP,2016,156,0,156
NARCOTICS,POSS: PCP,2017,181,0,181
NARCOTICS,POSS: PCP,2018,218,0,218
NARCOTICS,POSS: SYNTHETIC DRUGS,2008,202,8,194
NARCOTICS,POSS: SYNTHETIC DRUGS,2009,276,4,272
NARCOTICS,POSS: SYNTHETIC DRUGS,2010,344,3,341
NARCOTICS,POSS: SYNTHETIC DRUGS,2011,222,1,221
NARCOTICS,POSS: SYNTHETIC DRUGS,2012,258,3,255
NARCOTICS,POSS: SYNTHETIC DRUGS,2013,349,0,349
NARCOTICS,POSS: SYNTHETIC DRUGS,2014,396,2,394
NARCOTICS,POSS: SYNTHETIC DRUGS,2015,424,0,424
NARCOTICS,POSS: SYNTHETIC DRUGS,2016,200,0,200
NARCOTICS,POSS: SYNTHETIC DRUGS,2017,258,0,258
NARCOTICS,POSS: SYNTHETIC DRUGS,2018,314,0,314
NARCOTICS,POSSESSION OF DRUG EQUIPMENT,2008,1822,28,1794
NARCOTICS,POSSESSION OF DRUG EQUIPMENT,2009,1368,8,1360
NARCOTICS,POSSESSION OF DRUG EQUIPMENT,2010,1248,2,1246
NARCOTICS,POSSESSION OF DRUG EQUIPMENT,2011,515,0,515
NARCOTICS,POSSESSION OF DRUG EQUIPMENT,2012,402,0,402
NARCOTICS,POSSESSION OF DRUG EQUIPMENT,2013,480,1,479
NARCOTICS,POSSESSION OF DRUG EQUIPMENT,2014,413,1,412
NARCOTICS,POSSESSION OF DRUG EQUIPMENT,2015,343,1,342
NARCOTICS,POSSESSION OF DRUG EQUIPMENT,2016,167,0,167
NARCOTICS,POSSESSION OF DRUG EQUIPMENT,2017,115,0,115
NARCOTICS,POSSESSION OF DRUG EQUIPMENT,2018,154,1,153
NARCOTICS,POSSESSION: SYNTHETIC MARIJUANA,2012,30,0,30
NARCOTICS,POSSESSION: SYNTHETIC MARIJUANA,2013,37,4,33
NARCOTICS,POSSESSION: SYNTHETIC MARIJUANA,2014,27,0,27
NARCOTICS,POSSESSION: SYNTHETIC MARIJUANA,2015,29,0,29
NARCOTICS,POSSESSION: SYNTHETIC MARIJUANA,2016,15,0,15
NARCOTICS,POSSESSION: SYNTHETIC MARIJUANA,2017,16,0,16
NARCOTICS,POSSESSION: SYNTHETIC MARIJUANA,2018,11,0,11
NARCOTICS,SALE/DEL DRUG PARAPHERNALIA,2008,28,0,28
NARCOTICS,SALE/DEL DRUG PARAPHERNALIA,2009,18,0,18
NARCOTICS,SALE/DEL DRUG PARAPHERNALIA,2010,20,0,20
NARCOTICS,SALE/DEL DRUG PARAPHERNALIA,2011,11,0,11
NARCOTICS,SALE/DEL DRUG PARAPHERNALIA,2012,5,0,5
NARCOTICS,SALE/DEL DRUG PARAPHERNALIA,2013,8,0,8
NARCOTICS,SALE/DEL DRUG PARAPHERNALIA,2014,10,0,10
NARCOTICS,SALE/DEL DRUG PARAPHERNALIA,2015,3,0,3
NARCOTICS,SALE/DEL DRUG PARAPHERNALIA,2016,1,0,1
NARCOTICS,SALE/DEL DRUG PARAPHERNALIA,2017,3,0,3
NARCOTICS,SALE/DEL DRUG PARAPHERNALIA,2018,5,0,5
NARCOTICS,SALE/DEL HYPODERMIC NEEDLE,2008,16,0,16
NARCOTICS,SALE/DEL HYPODERMIC NEEDLE,2010,4,0,4
NARCOTICS,SALE/DEL HYPODERMIC NEEDLE,2014,1,0,1
NARCOTICS,SOLICIT NARCOTICS ON PUBLICWAY,2008,3008,26,2982
NARCOTICS,SOLICIT NARCOTICS ON PUBLICWAY,2009,2838,6,2832
NARCOTICS,SOLICIT NARCOTICS ON PUBLICWAY,2010,2027,5,2022
NARCOTICS,SOLICIT NARCOTICS ON PUBLICWAY,2011,767,1,766
NARCOTICS,SOLICIT NARCOTICS ON PUBLICWAY,2012,672,0,672
NARCOTICS,SOLICIT NARCOTICS ON PUBLICWAY,2013,678,0,678
NARCOTICS,SOLICIT NARCOTICS ON PUBLICWAY,2014,542,0,542
NARCOTICS,SOLICIT NARCOTICS ON PUBLICWAY,2015,363,0,363
NARCOTICS,SOLICIT NARCOTICS ON PUBLICWAY,2016,208,0,208
NARCOTICS,SOLICIT NARCOTICS ON PUBLICWAY,2017,373,0,373
NARCOTICS,SOLICIT NARCOTICS ON PUBLICWAY,2018,547,0,547
NON - CRIMINAL,FOID - REVOCATION,2015,20,16,4
NON - CRIMINAL,FOID - REVOCATION,2016,5,3,2
NON-CRIMINAL,CONCEALED CARRY LICENSE REVOCATION,2015,1,0,1
NON-CRIMINAL,FOID - REVOCATION,2015,1,0,1
NON-CRIMINAL,FOID - REVOCATION,2016,10,9,1
NON-CRIMINAL,FOID - REVOCATION,2018,15,13,2
NON-CRIMINAL,LOST PASSPORT,2012,6,5,1
NON-CRIMINAL,LOST PASSPORT,2013,3,2,1
NON-CRIMINAL,LOST PASSPORT,2017,26,25,1
NON-CRIMINAL,NOTIFICATION OF STALKING - NO CONTACT ORDER,2015,1,0,1
NON-CRIMINAL,NOTIFICATION OF STALKING - NO CONTACT ORDER,2016,1,0,1
NON-CRIMINAL (SUBJECT SPECIFIED),NOTIFICATION OF CIVIL NO CONTACT ORDER,2012,2,1,1
NON-CRIMINAL (SUBJECT SPECIFIED),NOTIFICATION OF CIVIL NO CONTACT ORDER,2017,2,1,1
NON-CRIMINAL (SUBJECT SPECIFIED),NOTIFICATION OF CIVIL NO CONTACT ORDER,2018,3,2,1
OBSCENITY,OBSCENE MATTER,2008,24,0,24
OBSCENITY,OBSCENE MATTER,2009,26,0,26
OBSCENITY,OBSCENE MATTER,2010,34,2,32
OBSCENITY,OBSCENE MATTER,2011,26,3,23
OBSCENITY,OBSCENE MATTER,2012,14,0,14
OBSCENITY,OBSCENE MATTER,2013,11,0,11
OBSCENITY,OBSCENE MATTER,2014,18,0,18
OBSCENITY,OBSCENE MATTER,2015,19,0,19
OBSCENITY,OBSCENE MATTER,2016,23,1,22
OBSCENITY,OBSCENE MATTER,2017,48,1,47
OBSCENITY,OBSCENE MATTER,2018,60,1,59
OBSCENITY,OBSCENITY,2009,10,8,2
OBSCENITY,OBSCENITY,2010,10,8,2
OBSCENITY,OBSCENITY,2011,8,6,2
OBSCENITY,OBSCENITY,2012,5,3,2
OBSCENITY,OBSCENITY,2013,6,3,3
OBSCENITY,OBSCENITY,2015,12,9,3
OBSCENITY,OBSCENITY,2017,15,13,2
OBSCENITY,OBSCENITY,2018,10,9,1
OBSCENITY,SALE/DIST OBSCENE MAT TO MINOR,2009,4,0,4
OBSCENITY,SALE/DIST OBSCENE MAT TO MINOR,2010,17,2,15
OBSCENITY,SALE/DIST OBSCENE MAT TO MINOR,2011,6,0,6
OBSCENITY,SALE/DIST OBSCENE MAT TO MINOR,2012,7,0,7
OBSCENITY,SALE/DIST OBSCENE MAT TO MINOR,2013,4,1,3
OBSCENITY,SALE/DIST OBSCENE MAT TO MINOR,2014,6,0,6
OBSCENITY,SALE/DIST OBSCENE MAT TO MINOR,2015,13,1,12
OBSCENITY,SALE/DIST OBSCENE MAT TO MINOR,2016,14,0,14
OBSCENITY,SALE/DIST OBSCENE MAT TO MINOR,2017,17,1,16
OBSCENITY,SALE/DIST OBSCENE MAT TO MINOR,2018,12,2,10
OFFENSE INVOLVING CHILDREN,AGG CRIM SEX ABUSE FAM MEMBER,2008,218,184,34
OFFENSE INVOLVING CHILDREN,AGG CRIM SEX ABUSE FAM MEMBER,2009,184,148,36
OFFENSE INVOLVING CHILDREN,AGG CRIM SEX ABUSE FAM MEMBER,2010,234,191,43
OFFENSE INVOLVING CHILDREN,AGG CRIM SEX ABUSE FAM MEMBER,2011,106,83,23
OFFENSE INVOLVING CHILDREN,AGG CRIM SEX ABUSE FAM MEMBER,2012,106,88,18
OFFENSE INVOLVING CHILDREN,AGG CRIM SEX ABUSE FAM MEMBER,2013,100,83,17
OFFENSE INVOLVING CHILDREN,AGG CRIM SEX ABUSE FAM MEMBER,2014,109,94,15
OFFENSE INVOLVING CHILDREN,AGG CRIM SEX ABUSE FAM MEMBER,2015,148,129,19
OFFENSE INVOLVING CHILDREN,AGG CRIM SEX ABUSE FAM MEMBER,2016,74,69,5
OFFENSE INVOLVING CHILDREN,AGG CRIM SEX ABUSE FAM MEMBER,2017,158,148,10
OFFENSE INVOLVING CHILDREN,AGG CRIM SEX ABUSE FAM MEMBER,2018,230,222,8
OFFENSE INVOLVING CHILDREN,AGG SEX ASSLT OF CHILD FAM MBR,2008,193,136,57
OFFENSE INVOLVING CHILDREN,AGG SEX ASSLT OF CHILD FAM MBR,2009,184,142,42
OFFENSE INVOLVING CHILDREN,AGG SEX ASSLT OF CHILD FAM MBR,2010,171,130,41
OFFENSE INVOLVING CHILDREN,AGG SEX ASSLT OF CHILD FAM MBR,2011,82,57,25
OFFENSE INVOLVING CHILDREN,AGG SEX ASSLT OF CHILD FAM MBR,2012,73,56,17
OFFENSE INVOLVING CHILDREN,AGG SEX ASSLT OF CHILD FAM MBR,2013,54,42,12
OFFENSE INVOLVING CHILDREN,AGG SEX ASSLT OF CHILD FAM MBR,2014,70,52,18
OFFENSE INVOLVING CHILDREN,AGG SEX ASSLT OF CHILD FAM MBR,2015,52,39,13
OFFENSE INVOLVING CHILDREN,AGG SEX ASSLT OF CHILD FAM MBR,2016,30,26,4
OFFENSE INVOLVING CHILDREN,AGG SEX ASSLT OF CHILD FAM MBR,2017,91,81,10
OFFENSE INVOLVING CHILDREN,AGG SEX ASSLT OF CHILD FAM MBR,2018,134,123,11
OFFENSE INVOLVING CHILDREN,CHILD ABANDONMENT,2008,96,76,20
OFFENSE INVOLVING CHILDREN,CHILD ABANDONMENT,2009,68,42,26
OFFENSE INVOLVING CHILDREN,CHILD ABANDONMENT,2010,94,62,32
OFFENSE INVOLVING CHILDREN,CHILD ABANDONMENT,2011,52,36,16
OFFENSE INVOLVING CHILDREN,CHILD ABANDONMENT,2012,39,28,11
OFFENSE INVOLVING CHILDREN,CHILD ABANDONMENT,2013,48,36,12
OFFENSE INVOLVING CHILDREN,CHILD ABANDONMENT,2014,42,37,5
OFFENSE INVOLVING CHILDREN,CHILD ABANDONMENT,2015,36,30,6
OFFENSE INVOLVING CHILDREN,CHILD ABANDONMENT,2016,32,25,7
OFFENSE INVOLVING CHILDREN,CHILD ABANDONMENT,2017,45,38,7
OFFENSE INVOLVING CHILDREN,CHILD ABANDONMENT,2018,26,24,2
OFFENSE INVOLVING CHILDREN,CHILD ABDUCTION,2008,418,388,30
OFFENSE INVOLVING CHILDREN,CHILD ABDUCTION,2009,338,318,20
OFFENSE INVOLVING CHILDREN,CHILD ABDUCTION,2010,281,266,15
OFFENSE INVOLVING CHILDREN,CHILD ABDUCTION,2011,131,127,4
OFFENSE INVOLVING CHILDREN,CHILD ABDUCTION,2012,113,106,7
OFFENSE INVOLVING CHILDREN,CHILD ABDUCTION,2013,112,104,8
OFFENSE INVOLVING CHILDREN,CHILD ABDUCTION,2014,104,98,6
OFFENSE INVOLVING CHILDREN,CHILD ABDUCTION,2015,112,98,14
OFFENSE INVOLVING CHILDREN,CHILD ABDUCTION,2016,120,117,3
OFFENSE INVOLVING CHILDREN,CHILD ABDUCTION,2017,98,89,9
OFFENSE INVOLVING CHILDREN,CHILD ABDUCTION,2018,97,88,9
OFFENSE INVOLVING CHILDREN,CHILD ABUSE,2008,1600,1132,468
OFFENSE INVOLVING CHILDREN,CHILD ABUSE,2009,1546,1150,396
OFFENSE INVOLVING CHILDREN,CHILD ABUSE,2010,1484,1094,390
OFFENSE INVOLVING CHILDREN,CHILD ABUSE,2011,686,516,170
OFFENSE INVOLVING CHILDREN,CHILD ABUSE,2012,604,459,145
OFFENSE INVOLVING CHILDREN,CHILD ABUSE,2013,733,578,155
OFFENSE INVOLVING CHILDREN,CHILD ABUSE,2014,699,529,170
OFFENSE INVOLVING CHILDREN,CHILD ABUSE,2015,706,574,132
OFFENSE INVOLVING CHILDREN,CHILD ABUSE,2016,700,600,100
OFFENSE INVOLVING CHILDREN,CHILD ABUSE,2017,660,519,141
OFFENSE INVOLVING CHILDREN,CHILD ABUSE,2018,648,559,89
OFFENSE INVOLVING CHILDREN,CHILD PORNOGRAPHY,2008,38,28,10
OFFENSE INVOLVING CHILDREN,CHILD PORNOGRAPHY,2009,40,34,6
OFFENSE INVOLVING CHILDREN,CHILD PORNOGRAPHY,2010,39,28,11
OFFENSE INVOLVING CHILDREN,CHILD PORNOGRAPHY,2011,24,18,6
OFFENSE INVOLVING CHILDREN,CHILD PORNOGRAPHY,2012,36,31,5
OFFENSE INVOLVING CHILDREN,CHILD PORNOGRAPHY,2013,106,96,10
OFFENSE INVOLVING CHILDREN,CHILD PORNOGRAPHY,2014,120,112,8
OFFENSE INVOLVING CHILDREN,CHILD PORNOGRAPHY,2015,83,76,7
OFFENSE INVOLVING CHILDREN,CHILD PORNOGRAPHY,2016,76,72,4
OFFENSE INVOLVING CHILDREN,CHILD PORNOGRAPHY,2017,99,96,3
OFFENSE INVOLVING CHILDREN,CHILD PORNOGRAPHY,2018,101,100,1
OFFENSE INVOLVING CHILDREN,CONTRIBUTE CRIM DELINQUENCY JUVENILE,2009,6,4,2
OFFENSE INVOLVING CHILDREN,CONTRIBUTE CRIM DELINQUENCY JUVENILE,2010,31,15,16
OFFENSE INVOLVING CHILDREN,CONTRIBUTE CRIM DELINQUENCY JUVENILE,2011,9,5,4
OFFENSE INVOLVING CHILDREN,CONTRIBUTE CRIM DELINQUENCY JUVENILE,2012,7,2,5
OFFENSE INVOLVING CHILDREN,CONTRIBUTE CRIM DELINQUENCY JUVENILE,2013,12,8,4
OFFENSE INVOLVING CHILDREN,CONTRIBUTE CRIM DELINQUENCY JUVENILE,2014,14,8,6
OFFENSE INVOLVING CHILDREN,CONTRIBUTE CRIM DELINQUENCY JUVENILE,2015,10,5,5
OFFENSE INVOLVING CHILDREN,CONTRIBUTE CRIM DELINQUENCY JUVENILE,2017,15,10,5
OFFENSE INVOLVING CHILDREN,CONTRIBUTE CRIM DELINQUENCY JUVENILE,2018,5,4,1
OFFENSE INVOLVING CHILDREN,CONTRIBUTE DELINQUENCY OF A CHILD,2008,66,40,26
OFFENSE INVOLVING CHILDREN,CONTRIBUTE DELINQUENCY OF A CHILD,2009,72,44,28
OFFENSE INVOLVING CHILDREN,CONTRIBUTE DELINQUENCY OF A CHILD,2010,52,36,16
OFFENSE INVOLVING CHILDREN,CONTRIBUTE DELINQUENCY OF A CHILD,2011,18,8,10
OFFENSE INVOLVING CHILDREN,CONTRIBUTE DELINQUENCY OF A CHILD,2012,25,15,10
OFFENSE INVOLVING CHILDREN,CONTRIBUTE DELINQUENCY OF A CHILD,2013,17,8,9
OFFENSE INVOLVING CHILDREN,CONTRIBUTE DELINQUENCY OF A CHILD,2014,14,3,11
OFFENSE INVOLVING CHILDREN,CONTRIBUTE DELINQUENCY OF A CHILD,2015,21,13,8
OFFENSE INVOLVING CHILDREN,CONTRIBUTE DELINQUENCY OF A CHILD,2016,12,9,3
OFFENSE INVOLVING CHILDREN,CONTRIBUTE DELINQUENCY OF A CHILD,2017,13,11,2
OFFENSE INVOLVING CHILDREN,CONTRIBUTE DELINQUENCY OF A CHILD,2018,6,3,3
OFFENSE INVOLVING CHILDREN,CRIM SEX ABUSE BY FAM MEMBER,2008,160,144,16
OFFENSE INVOLVING CHILDREN,CRIM SEX ABUSE BY FAM MEMBER,2009,150,132,18
OFFENSE INVOLVING CHILDREN,CRIM SEX ABUSE BY FAM MEMBER,2010,161,141,20
OFFENSE INVOLVING CHILDREN,CRIM SEX ABUSE BY FAM MEMBER,2011,94,78,16
OFFENSE INVOLVING CHILDREN,CRIM SEX ABUSE BY FAM MEMBER,2012,95,88,7
OFFENSE INVOLVING CHILDREN,CRIM SEX ABUSE BY FAM MEMBER,2013,65,54,11
OFFENSE INVOLVING CHILDREN,CRIM SEX ABUSE BY FAM MEMBER,2014,69,58,11
OFFENSE INVOLVING CHILDREN,CRIM SEX ABUSE BY FAM MEMBER,2015,101,91,10
OFFENSE INVOLVING CHILDREN,CRIM SEX ABUSE BY FAM MEMBER,2016,64,60,4
OFFENSE INVOLVING CHILDREN,CRIM SEX ABUSE BY FAM MEMBER,2017,138,131,7
OFFENSE INVOLVING CHILDREN,CRIM SEX ABUSE BY FAM MEMBER,2018,89,83,6
OFFENSE INVOLVING CHILDREN,ENDANGERING LIFE/HEALTH CHILD,2008,668,400,268
OFFENSE INVOLVING CHILDREN,ENDANGERING LIFE/HEALTH CHILD,2009,746,448,298
OFFENSE INVOLVING CHILDREN,ENDANGERING LIFE/HEALTH CHILD,2010,695,408,287
OFFENSE INVOLVING CHILDREN,ENDANGERING LIFE/HEALTH CHILD,2011,332,202,130
OFFENSE INVOLVING CHILDREN,ENDANGERING LIFE/HEALTH CHILD,2012,334,193,141
OFFENSE INVOLVING CHILDREN,ENDANGERING LIFE/HEALTH CHILD,2013,272,160,112
OFFENSE INVOLVING CHILDREN,ENDANGERING LIFE/HEALTH CHILD,2014,316,178,138
OFFENSE INVOLVING CHILDREN,ENDANGERING LIFE/HEALTH CHILD,2015,287,167,120
OFFENSE INVOLVING CHILDREN,ENDANGERING LIFE/HEALTH CHILD,2016,278,188,90
OFFENSE INVOLVING CHILDREN,ENDANGERING LIFE/HEALTH CHILD,2017,325,215,110
OFFENSE INVOLVING CHILDREN,ENDANGERING LIFE/HEALTH CHILD,2018,315,223,92
OFFENSE INVOLVING CHILDREN,HARBOR RUNAWAY,2008,26,16,10
OFFENSE INVOLVING CHILDREN,HARBOR RUNAWAY,2009,16,12,4
OFFENSE INVOLVING CHILDREN,HARBOR RUNAWAY,2010,14,10,4
OFFENSE INVOLVING CHILDREN,HARBOR RUNAWAY,2011,18,11,7
OFFENSE INVOLVING CHILDREN,HARBOR RUNAWAY,2012,8,5,3
OFFENSE INVOLVING CHILDREN,HARBOR RUNAWAY,2013,7,5,2
OFFENSE INVOLVING CHILDREN,HARBOR RUNAWAY,2014,14,6,8
OFFENSE INVOLVING CHILDREN,HARBOR RUNAWAY,2015,6,5,1
OFFENSE INVOLVING CHILDREN,HARBOR RUNAWAY,2016,3,2,1
OFFENSE INVOLVING CHILDREN,HARBOR RUNAWAY,2018,5,4,1
OFFENSE INVOLVING CHILDREN,OTHER OFFENSE,2008,1238,1222,16
OFFENSE INVOLVING CHILDREN,OTHER OFFENSE,2009,1308,1280,28
OFFENSE INVOLVING CHILDREN,OTHER OFFENSE,2010,1140,1124,16
OFFENSE INVOLVING CHILDREN,OTHER OFFENSE,2011,648,639,9
OFFENSE INVOLVING CHILDREN,OTHER OFFENSE,2012,625,618,7
OFFENSE INVOLVING CHILDREN,OTHER OFFENSE,2013,628,621,7
OFFENSE INVOLVING CHILDREN,OTHER OFFENSE,2014,588,583,5
OFFENSE INVOLVING CHILDREN,OTHER OFFENSE,2015,529,523,6
OFFENSE INVOLVING CHILDREN,OTHER OFFENSE,2016,528,523,5
OFFENSE INVOLVING CHILDREN,OTHER OFFENSE,2017,412,406,6
OFFENSE INVOLVING CHILDREN,OTHER OFFENSE,2018,368,365,3
OFFENSE INVOLVING CHILDREN,POS: PORNOGRAPHIC PRINT,2008,14,6,8
OFFENSE INVOLVING CHILDREN,POS: PORNOGRAPHIC PRINT,2009,2,0,2
OFFENSE INVOLVING CHILDREN,POS: PORNOGRAPHIC PRINT,2010,8,2,6
OFFENSE INVOLVING CHILDREN,POS: PORNOGRAPHIC PRINT,2011,2,0,2
OFFENSE INVOLVING CHILDREN,POS: PORNOGRAPHIC PRINT,2012,4,1,3
OFFENSE INVOLVING CHILDREN,POS: PORNOGRAPHIC PRINT,2013,3,0,3
OFFENSE INVOLVING CHILDREN,POS: PORNOGRAPHIC PRINT,2014,3,0,3
OFFENSE INVOLVING CHILDREN,POS: PORNOGRAPHIC PRINT,2015,4,1,3
OFFENSE INVOLVING CHILDREN,POS: PORNOGRAPHIC PRINT,2016,4,1,3
OFFENSE INVOLVING CHILDREN,POS: PORNOGRAPHIC PRINT,2017,4,0,4
OFFENSE INVOLVING CHILDREN,POS: PORNOGRAPHIC PRINT,2018,11,1,10
OFFENSE INVOLVING CHILDREN,SALE TOBACCO PRODUCTS TO MINOR,2008,6,0,6
OFFENSE INVOLVING CHILDREN,SALE TOBACCO PRODUCTS TO MINOR,2009,4,2,2
OFFENSE INVOLVING CHILDREN,SALE TOBACCO PRODUCTS TO MINOR,2010,6,2,4
OFFENSE INVOLVING CHILDREN,SALE TOBACCO PRODUCTS TO MINOR,2011,2,0,2
OFFENSE INVOLVING CHILDREN,SALE TOBACCO PRODUCTS TO MINOR,2012,4,0,4
OFFENSE INVOLVING CHILDREN,SALE TOBACCO PRODUCTS TO MINOR,2013,1,0,1
OFFENSE INVOLVING CHILDREN,SALE TOBACCO PRODUCTS TO MINOR,2015,1,0,1
OFFENSE INVOLVING CHILDREN,SALE TOBACCO PRODUCTS TO MINOR,2016,1,0,1
OFFENSE INVOLVING CHILDREN,SALE TOBACCO PRODUCTS TO MINOR,2017,1,0,1
OFFENSE INVOLVING CHILDREN,SALE TOBACCO PRODUCTS TO MINOR,2018,2,1,1
OFFENSE INVOLVING CHILDREN,SEX ASSLT OF CHILD BY FAM MBR,2008,112,82,30
OFFENSE INVOLVING CHILDREN,SEX ASSLT OF CHILD BY FAM MBR,2009,108,82,26
OFFENSE INVOLVING CHILDREN,SEX ASSLT OF CHILD BY FAM MBR,2010,97,86,11
OFFENSE INVOLVING CHILDREN,SEX ASSLT OF CHILD BY FAM MBR,2011,53,40,13
OFFENSE INVOLVING CHILDREN,SEX ASSLT OF CHILD BY FAM MBR,2012,39,32,7
OFFENSE INVOLVING CHILDREN,SEX ASSLT OF CHILD BY FAM MBR,2013,30,24,6
OFFENSE INVOLVING CHILDREN,SEX ASSLT OF CHILD BY FAM MBR,2014,27,20,7
OFFENSE INVOLVING CHILDREN,SEX ASSLT OF CHILD BY FAM MBR,2015,53,45,8
OFFENSE INVOLVING CHILDREN,SEX ASSLT OF CHILD BY FAM MBR,2016,30,28,2
OFFENSE INVOLVING CHILDREN,SEX ASSLT OF CHILD BY FAM MBR,2017,86,82,4
OFFENSE INVOLVING CHILDREN,SEX ASSLT OF CHILD BY FAM MBR,2018,42,38,4
OTHER NARCOTIC VIOLATION,INTOXICATING COMPOUNDS,2008,24,2,22
OTHER NARCOTIC VIOLATION,INTOXICATING COMPOUNDS,2009,14,4,10
OTHER NARCOTIC VIOLATION,INTOXICATING COMPOUNDS,2010,11,8,3
OTHER NARCOTIC VIOLATION,INTOXICATING COMPOUNDS,2011,5,2,3
OTHER NARCOTIC VIOLATION,INTOXICATING COMPOUNDS,2012,6,2,4
OTHER NARCOTIC VIOLATION,INTOXICATING COMPOUNDS,2013,5,1,4
OTHER NARCOTIC VIOLATION,INTOXICATING COMPOUNDS,2014,10,2,8
OTHER NARCOTIC VIOLATION,INTOXICATING COMPOUNDS,2015,5,3,2
OTHER NARCOTIC VIOLATION,INTOXICATING COMPOUNDS,2016,4,1,3
OTHER NARCOTIC VIOLATION,INTOXICATING COMPOUNDS,2017,11,4,7
OTHER OFFENSE,ABUSE/NEGLECT: CARE FACILITY,2009,8,6,2
OTHER OFFENSE,ABUSE/NEGLECT: CARE FACILITY,2012,8,7,1
OTHER OFFENSE,ABUSE/NEGLECT: CARE FACILITY,2014,8,7,1
OTHER OFFENSE,ABUSE/NEGLECT: CARE FACILITY,2015,12,11,1
OTHER OFFENSE,ABUSE/NEGLECT: CARE FACILITY,2018,11,10,1
OTHER OFFENSE,ANIMAL ABUSE/NEGLECT,2008,374,278,96
OTHER OFFENSE,ANIMAL ABUSE/NEGLECT,2009,268,168,100
OTHER OFFENSE,ANIMAL ABUSE/NEGLECT,2010,211,134,77
OTHER OFFENSE,ANIMAL ABUSE/NEGLECT,2011,159,94,65
OTHER OFFENSE,ANIMAL ABUSE/NEGLECT,2012,142,91,51
OTHER OFFENSE,ANIMAL ABUSE/NEGLECT,2013,170,120,50
OTHER OFFENSE,ANIMAL ABUSE/NEGLECT,2014,157,111,46
OTHER OFFENSE,ANIMAL ABUSE/NEGLECT,2015,156,104,52
OTHER OFFENSE,ANIMAL ABUSE/NEGLECT,2016,148,117,31
OTHER OFFENSE,ANIMAL ABUSE/NEGLECT,2017,128,97,31
OTHER OFFENSE,ANIMAL ABUSE/NEGLECT,2018,104,89,15
OTHER OFFENSE,ANIMAL FIGHTING,2009,14,6,8
OTHER OFFENSE,ANIMAL FIGHTING,2010,12,8,4
OTHER OFFENSE,ANIMAL FIGHTING,2011,5,3,2
OTHER OFFENSE,ANIMAL FIGHTING,2015,1,0,1
OTHER OFFENSE,ARSONIST: ANNUAL REGISTRATION,2015,1,0,1
OTHER OFFENSE,ARSONIST: ANNUAL REGISTRATION,2016,4,0,4
OTHER OFFENSE,ARSONIST: ANNUAL REGISTRATION,2017,5,2,3
OTHER OFFENSE,ARSONIST: ANNUAL REGISTRATION,2018,3,2,1
OTHER OFFENSE,ARSONIST: DUTY TO REGISTER,2017,1,0,1
OTHER OFFENSE,ARSONIST: DUTY TO REGISTER,2018,3,1,2
OTHER OFFENSE,ARSONIST: FAIL TO REGISTER NEW ADDRESS,2017,2,0,2
OTHER OFFENSE,ARSONIST: FAIL TO REGISTER NEW ADDRESS,2018,1,0,1
OTHER OFFENSE,BOARD PLANE WITH WEAPON,2008,14,2,12
OTHER OFFENSE,BOARD PLANE WITH WEAPON,2009,18,2,16
OTHER OFFENSE,BOARD PLANE WITH WEAPON,2010,3,0,3
OTHER OFFENSE,BOARD PLANE WITH WEAPON,2011,6,0,6
OTHER OFFENSE,BOARD PLANE WITH WEAPON,2012,12,0,12
OTHER OFFENSE,BOARD PLANE WITH WEAPON,2013,14,1,13
OTHER OFFENSE,BOARD PLANE WITH WEAPON,2014,10,0,10
OTHER OFFENSE,BOARD PLANE WITH WEAPON,2015,7,0,7
OTHER OFFENSE,BOARD PLANE WITH WEAPON,2016,8,1,7
OTHER OFFENSE,BOARD PLANE WITH WEAPON,2017,13,0,13
OTHER OFFENSE,BOARD PLANE WITH WEAPON,2018,13,0,13
OTHER OFFENSE,COMPOUNDING A CRIME,2010,4,0,4
OTHER OFFENSE,EAVESDROPPING,2009,4,0,4
OTHER OFFENSE,EAVESDROPPING,2010,12,10,2
OTHER OFFENSE,EAVESDROPPING,2011,11,6,5
OTHER OFFENSE,EAVESDROPPING,2012,4,3,1
OTHER OFFENSE,FALSE/STOLEN/ALTERED TRP,2008,3226,2264,962
OTHER OFFENSE,FALSE/STOLEN/ALTERED TRP,2009,4328,2432,1896
OTHER OFFENSE,FALSE/STOLEN/ALTERED TRP,2010,2586,1563,1023
OTHER OFFENSE,FALSE/STOLEN/ALTERED TRP,2011,938,478,460
OTHER OFFENSE,FALSE/STOLEN/ALTERED TRP,2012,683,403,280
OTHER OFFENSE,FALSE/STOLEN/ALTERED TRP,2013,657,345,312
OTHER OFFENSE,FALSE/STOLEN/ALTERED TRP,2014,530,231,299
OTHER OFFENSE,FALSE/STOLEN/ALTERED TRP,2015,573,274,299
OTHER OFFENSE,FALSE/STOLEN/ALTERED TRP,2016,712,296,416
OTHER OFFENSE,FALSE/STOLEN/ALTERED TRP,2017,853,346,507
OTHER OFFENSE,FALSE/STOLEN/ALTERED TRP,2018,856,294,562
OTHER OFFENSE,FIREARM REGISTRATION VIOLATION,2008,20,6,14
OTHER OFFENSE,FIREARM REGISTRATION VIOLATION,2009,10,0,10
OTHER OFFENSE,FIREARM REGISTRATION VIOLATION,2010,22,4,18
OTHER OFFENSE,FIREARM REGISTRATION VIOLATION,2011,26,2,24
OTHER OFFENSE,FIREARM REGISTRATION VIOLATION,2012,16,1,15
OTHER OFFENSE,FIREARM REGISTRATION VIOLATION,2013,9,3,6
OTHER OFFENSE,GUN OFFENDER: ANNUAL REGISTRATION,2013,15,1,14
OTHER OFFENSE,GUN OFFENDER: ANNUAL REGISTRATION,2014,150,1,149
OTHER OFFENSE,GUN OFFENDER: ANNUAL REGISTRATION,2015,187,0,187
OTHER OFFENSE,GUN OFFENDER: ANNUAL REGISTRATION,2016,139,2,137
OTHER OFFENSE,GUN OFFENDER: ANNUAL REGISTRATION,2017,287,8,279
OTHER OFFENSE,GUN OFFENDER: ANNUAL REGISTRATION,2018,301,2,299
OTHER OFFENSE,GUN OFFENDER: DUTY TO REGISTER,2011,73,2,71
OTHER OFFENSE,GUN OFFENDER: DUTY TO REGISTER,2012,54,1,53
OTHER OFFENSE,GUN OFFENDER: DUTY TO REGISTER,2013,25,0,25
OTHER OFFENSE,GUN OFFENDER: DUTY TO REGISTER,2014,63,3,60
OTHER OFFENSE,GUN OFFENDER: DUTY TO REGISTER,2015,86,1,85
OTHER OFFENSE,GUN OFFENDER: DUTY TO REGISTER,2016,104,1,103
OTHER OFFENSE,GUN OFFENDER: DUTY TO REGISTER,2017,182,4,178
OTHER OFFENSE,GUN OFFENDER: DUTY TO REGISTER,2018,181,2,179
OTHER OFFENSE,GUN OFFENDER: DUTY TO REPORT CHANGE OF INFORMATION,2014,20,0,20
OTHER OFFENSE,GUN OFFENDER: DUTY TO REPORT CHANGE OF INFORMATION,2015,16,0,16
OTHER OFFENSE,GUN OFFENDER: DUTY TO REPORT CHANGE OF INFORMATION,2016,9,1,8
OTHER OFFENSE,GUN OFFENDER: DUTY TO REPORT CHANGE OF INFORMATION,2017,26,0,26
OTHER OFFENSE,GUN OFFENDER: DUTY TO REPORT CHANGE OF INFORMATION,2018,82,4,78
OTHER OFFENSE,HARASSMENT BY ELECTRONIC MEANS,2008,2002,1962,40
OTHER OFFENSE,HARASSMENT BY ELECTRONIC MEANS,2009,2616,2572,44
OTHER OFFENSE,HARASSMENT BY ELECTRONIC MEANS,2010,2887,2834,53
OTHER OFFENSE,HARASSMENT BY ELECTRONIC MEANS,2011,1898,1856,42
OTHER OFFENSE,HARASSMENT BY ELECTRONIC MEANS,2012,1922,1863,59
OTHER OFFENSE,HARASSMENT BY ELECTRONIC MEANS,2013,1996,1955,41
OTHER OFFENSE,HARASSMENT BY ELECTRONIC MEANS,2014,1924,1865,59
OTHER OFFENSE,HARASSMENT BY ELECTRONIC MEANS,2015,2015,1956,59
OTHER OFFENSE,HARASSMENT BY ELECTRONIC MEANS,2016,2336,2304,32
OTHER OFFENSE,HARASSMENT BY ELECTRONIC MEANS,2017,2644,2606,38
OTHER OFFENSE,HARASSMENT BY ELECTRONIC MEANS,2018,2646,2610,36
OTHER OFFENSE,HARASSMENT BY TELEPHONE,2008,13072,12890,182
OTHER OFFENSE,HARASSMENT BY TELEPHONE,2009,11908,11708,200
OTHER OFFENSE,HARASSMENT BY TELEPHONE,2010,9316,9172,144
OTHER OFFENSE,HARASSMENT BY TELEPHONE,2011,4490,4420,70
OTHER OFFENSE,HARASSMENT BY TELEPHONE,2012,3832,3766,66
OTHER OFFENSE,HARASSMENT BY TELEPHONE,2013,3676,3610,66
OTHER OFFENSE,HARASSMENT BY TELEPHONE,2014,2938,2874,64
OTHER OFFENSE,HARASSMENT BY TELEPHONE,2015,2955,2910,45
OTHER OFFENSE,HARASSMENT BY TELEPHONE,2016,2540,2507,33
OTHER OFFENSE,HARASSMENT BY TELEPHONE,2017,2739,2697,42
OTHER OFFENSE,HARASSMENT BY TELEPHONE,2018,2508,2475,33
OTHER OFFENSE,HAZARDOUS MATERIALS VIOLATION,2008,18,16,2
OTHER OFFENSE,HAZARDOUS MATERIALS VIOLATION,2009,16,14,2
OTHER OFFENSE,HAZARDOUS MATERIALS VIOLATION,2010,14,12,2
OTHER OFFENSE,HAZARDOUS MATERIALS VIOLATION,2013,7,5,2
OTHER OFFENSE,HAZARDOUS MATERIALS VIOLATION,2015,4,3,1
OTHER OFFENSE,HAZARDOUS MATERIALS VIOLATION,2017,4,3,1
OTHER OFFENSE,HAZARDOUS MATERIALS VIOLATION,2018,3,2,1
OTHER OFFENSE,INTERFERE W/ HIGHER EDUCATION,2008,4,0,4
OTHER OFFENSE,INTERFERE W/ HIGHER EDUCATION,2010,10,8,2
OTHER OFFENSE,INTERFERE W/ HIGHER EDUCATION,2011,2,1,1
OTHER OFFENSE,INTERFERE W/ HIGHER EDUCATION,2012,1,0,1
OTHER OFFENSE,INTERFERE W/ HIGHER EDUCATION,2013,2,1,1
OTHER OFFENSE,INTERFERE W/ HIGHER EDUCATION,2014,1,0,1
OTHER OFFENSE,INTERFERE W/ HIGHER EDUCATION,2015,3,2,1
OTHER OFFENSE,INTERFERE W/ HIGHER EDUCATION,2016,1,0,1
OTHER OFFENSE,LICENSE VIOLATION,2008,518,166,352
OTHER OFFENSE,LICENSE VIOLATION,2009,502,202,300
OTHER OFFENSE,LICENSE VIOLATION,2010,720,306,414
OTHER OFFENSE,LICENSE VIOLATION,2011,462,238,224
OTHER OFFENSE,LICENSE VIOLATION,2012,367,183,184
OTHER OFFENSE,LICENSE VIOLATION,2013,644,286,358
OTHER OFFENSE,LICENSE VIOLATION,2014,695,472,223
OTHER OFFENSE,LICENSE VIOLATION,2015,592,463,129
OTHER OFFENSE,LICENSE VIOLATION,2016,467,370,97
OTHER OFFENSE,LICENSE VIOLATION,2017,474,358,116
OTHER OFFENSE,LICENSE VIOLATION,2018,431,350,81
OTHER OFFENSE,MONEY LAUNDERING,2008,12,10,2
OTHER OFFENSE,MONEY LAUNDERING,2009,16,14,2
OTHER OFFENSE,MONEY LAUNDERING,2010,14,7,7
OTHER OFFENSE,MONEY LAUNDERING,2011,7,6,1
OTHER OFFENSE,MONEY LAUNDERING,2012,9,5,4
OTHER OFFENSE,OBSCENE TELEPHONE CALLS,2008,490,482,8
OTHER OFFENSE,OBSCENE TELEPHONE CALLS,2009,390,386,4
OTHER OFFENSE,OBSCENE TELEPHONE CALLS,2011,122,121,1
OTHER OFFENSE,OBSCENE TELEPHONE CALLS,2012,78,77,1
OTHER OFFENSE,OBSCENE TELEPHONE CALLS,2016,26,25,1
OTHER OFFENSE,OTHER ARSON/EXPLOSIVE INCIDENT,2008,18,16,2
OTHER OFFENSE,OTHER ARSON/EXPLOSIVE INCIDENT,2009,36,26,10
OTHER OFFENSE,OTHER ARSON/EXPLOSIVE INCIDENT,2010,23,20,3
OTHER OFFENSE,OTHER ARSON/EXPLOSIVE INCIDENT,2011,9,8,1
OTHER OFFENSE,OTHER ARSON/EXPLOSIVE INCIDENT,2013,6,5,1
OTHER OFFENSE,OTHER ARSON/EXPLOSIVE INCIDENT,2014,7,5,2
OTHER OFFENSE,OTHER ARSON/EXPLOSIVE INCIDENT,2016,9,7,2
OTHER OFFENSE,OTHER CRIME AGAINST PERSON,2008,714,570,144
OTHER OFFENSE,OTHER CRIME AGAINST PERSON,2009,742,514,228
OTHER OFFENSE,OTHER CRIME AGAINST PERSON,2010,665,513,152
OTHER OFFENSE,OTHER CRIME AGAINST PERSON,2011,322,225,97
OTHER OFFENSE,OTHER CRIME AGAINST PERSON,2012,292,245,47
OTHER OFFENSE,OTHER CRIME AGAINST PERSON,2013,318,248,70
OTHER OFFENSE,OTHER CRIME AGAINST PERSON,2014,284,242,42
OTHER OFFENSE,OTHER CRIME AGAINST PERSON,2015,310,283,27
OTHER OFFENSE,OTHER CRIME AGAINST PERSON,2016,303,280,23
OTHER OFFENSE,OTHER CRIME AGAINST PERSON,2017,390,368,22
OTHER OFFENSE,OTHER CRIME AGAINST PERSON,2018,437,410,27
OTHER OFFENSE,OTHER CRIME INVOLVING PROPERTY,2008,1356,738,618
OTHER OFFENSE,OTHER CRIME INVOLVING PROPERTY,2009,980,426,554
OTHER OFFENSE,OTHER CRIME INVOLVING PROPERTY,2010,710,376,334
OTHER OFFENSE,OTHER CRIME INVOLVING PROPERTY,2011,336,213,123
OTHER OFFENSE,OTHER CRIME INVOLVING PROPERTY,2012,358,232,126
OTHER OFFENSE,OTHER CRIME INVOLVING PROPERTY,2013,299,210,89
OTHER OFFENSE,OTHER CRIME INVOLVING PROPERTY,2014,280,208,72
OTHER OFFENSE,OTHER CRIME INVOLVING PROPERTY,2015,248,202,46
OTHER OFFENSE,OTHER CRIME INVOLVING PROPERTY,2016,201,167,34
OTHER OFFENSE,OTHER CRIME INVOLVING PROPERTY,2017,227,208,19
OTHER OFFENSE,OTHER CRIME INVOLVING PROPERTY,2018,222,196,26
OTHER OFFENSE,OTHER VEHICLE OFFENSE,2008,3898,3366,532
OTHER OFFENSE,OTHER VEHICLE OFFENSE,2009,3392,2700,692
OTHER OFFENSE,OTHER VEHICLE OFFENSE,2010,2704,2221,483
OTHER OFFENSE,OTHER VEHICLE OFFENSE,2011,1157,944,213
OTHER OFFENSE,OTHER VEHICLE OFFENSE,2012,1067,885,182
OTHER OFFENSE,OTHER VEHICLE OFFENSE,2013,1349,1064,285
OTHER OFFENSE,OTHER VEHICLE OFFENSE,2014,1225,1008,217
OTHER OFFENSE,OTHER VEHICLE OFFENSE,2015,1077,894,183
OTHER OFFENSE,OTHER VEHICLE OFFENSE,2016,1193,1013,180
OTHER OFFENSE,OTHER VEHICLE OFFENSE,2017,1445,1238,207
OTHER OFFENSE,OTHER VEHICLE OFFENSE,2018,1362,1186,176
OTHER OFFENSE,OTHER WEAPONS VIOLATION,2008,1524,1220,304
OTHER OFFENSE,OTHER WEAPONS VIOLATION,2009,1302,1050,252
OTHER OFFENSE,OTHER WEAPONS VIOLATION,2010,879,655,224
OTHER OFFENSE,OTHER WEAPONS VIOLATION,2011,557,442,115
OTHER OFFENSE,OTHER WEAPONS VIOLATION,2012,408,303,105
OTHER OFFENSE,OTHER WEAPONS VIOLATION,2013,760,623,137
OTHER OFFENSE,OTHER WEAPONS VIOLATION,2014,655,545,110
OTHER OFFENSE,OTHER WEAPONS VIOLATION,2015,297,183,114
OTHER OFFENSE,OTHER WEAPONS VIOLATION,2016,168,79,89
OTHER OFFENSE,OTHER WEAPONS VIOLATION,2017,159,70,89
OTHER OFFENSE,OTHER WEAPONS VIOLATION,2018,156,48,108
OTHER OFFENSE,PAROLE VIOLATION,2008,20,0,20
OTHER OFFENSE,PAROLE VIOLATION,2009,10,0,10
OTHER OFFENSE,PAROLE VIOLATION,2010,16,2,14
OTHER OFFENSE,PAROLE VIOLATION,2011,17,4,13
OTHER OFFENSE,PAROLE VIOLATION,2012,43,0,43
OTHER OFFENSE,PAROLE VIOLATION,2013,343,5,338
OTHER OFFENSE,PAROLE VIOLATION,2014,1276,7,1269
OTHER OFFENSE,PAROLE VIOLATION,2015,1986,8,1978
OTHER OFFENSE,PAROLE VIOLATION,2016,853,6,847
OTHER OFFENSE,PAROLE VIOLATION,2017,652,2,650
OTHER OFFENSE,PAROLE VIOLATION,2018,45,0,45
OTHER OFFENSE,POSSESSION OF BURGLARY TOOLS,2008,134,32,102
OTHER OFFENSE,POSSESSION OF BURGLARY TOOLS,2009,100,10,90
OTHER OFFENSE,POSSESSION OF BURGLARY TOOLS,2010,91,14,77
OTHER OFFENSE,POSSESSION OF BURGLARY TOOLS,2011,52,5,47
OTHER OFFENSE,POSSESSION OF BURGLARY TOOLS,2012,56,2,54
OTHER OFFENSE,POSSESSION OF BURGLARY TOOLS,2013,28,0,28
OTHER OFFENSE,POSSESSION OF BURGLARY TOOLS,2014,30,3,27
OTHER OFFENSE,POSSESSION OF BURGLARY TOOLS,2015,25,0,25
OTHER OFFENSE,POSSESSION OF BURGLARY TOOLS,2016,10,1,9
OTHER OFFENSE,POSSESSION OF BURGLARY TOOLS,2017,7,0,7
OTHER OFFENSE,POSSESSION OF BURGLARY TOOLS,2018,7,2,5
OTHER OFFENSE,PROBATION VIOLATION,2008,302,22,280
OTHER OFFENSE,PROBATION VIOLATION,2009,298,16,282
OTHER OFFENSE,PROBATION VIOLATION,2010,361,66,295
OTHER OFFENSE,PROBATION VIOLATION,2011,281,52,229
OTHER OFFENSE,PROBATION VIOLATION,2012,189,8,181
OTHER OFFENSE,PROBATION VIOLATION,2013,220,6,214
OTHER OFFENSE,PROBATION VIOLATION,2014,131,3,128
OTHER OFFENSE,PROBATION VIOLATION,2015,90,3,87
OTHER OFFENSE,PROBATION VIOLATION,2016,34,3,31
OTHER OFFENSE,PROBATION VIOLATION,2017,29,0,29
OTHER OFFENSE,PROBATION VIOLATION,2018,8,0,8
OTHER OFFENSE,SEX OFFENDER: FAIL REG NEW ADD,2008,582,394,188
OTHER OFFENSE,SEX OFFENDER: FAIL REG NEW ADD,2009,481,246,235
OTHER OFFENSE,SEX OFFENDER: FAIL REG NEW ADD,2010,459,245,214
OTHER OFFENSE,SEX OFFENDER: FAIL REG NEW ADD,2011,247,118,129
OTHER OFFENSE,SEX OFFENDER: FAIL REG NEW ADD,2012,193,80,113
OTHER OFFENSE,SEX OFFENDER: FAIL REG NEW ADD,2013,216,79,137
OTHER OFFENSE,SEX OFFENDER: FAIL REG NEW ADD,2014,207,84,123
OTHER OFFENSE,SEX OFFENDER: FAIL REG NEW ADD,2015,191,107,84
OTHER OFFENSE,SEX OFFENDER: FAIL REG NEW ADD,2016,143,116,27
OTHER OFFENSE,SEX OFFENDER: FAIL REG NEW ADD,2017,170,124,46
OTHER OFFENSE,SEX OFFENDER: FAIL REG NEW ADD,2018,183,135,48
OTHER OFFENSE,SEX OFFENDER: FAIL TO REGISTER,2008,302,98,204
OTHER OFFENSE,SEX OFFENDER: FAIL TO REGISTER,2009,356,120,236
OTHER OFFENSE,SEX OFFENDER: FAIL TO REGISTER,2010,675,362,313
OTHER OFFENSE,SEX OFFENDER: FAIL TO REGISTER,2011,155,35,120
OTHER OFFENSE,SEX OFFENDER: FAIL TO REGISTER,2012,148,22,126
OTHER OFFENSE,SEX OFFENDER: FAIL TO REGISTER,2013,157,16,141
OTHER OFFENSE,SEX OFFENDER: FAIL TO REGISTER,2014,195,33,162
OTHER OFFENSE,SEX OFFENDER: FAIL TO REGISTER,2015,262,87,175
OTHER OFFENSE,SEX OFFENDER: FAIL TO REGISTER,2016,178,94,84
OTHER OFFENSE,SEX OFFENDER: FAIL TO REGISTER,2017,207,102,105
OTHER OFFENSE,SEX OFFENDER: FAIL TO REGISTER,2018,295,143,152
OTHER OFFENSE,SEX OFFENDER: PROHIBITED ZONE,2008,14,2,12
OTHER OFFENSE,SEX OFFENDER: PROHIBITED ZONE,2009,6,4,2
OTHER OFFENSE,SEX OFFENDER: PROHIBITED ZONE,2010,10,2,8
OTHER OFFENSE,SEX OFFENDER: PROHIBITED ZONE,2011,1,0,1
OTHER OFFENSE,SEX OFFENDER: PROHIBITED ZONE,2013,10,1,9
OTHER OFFENSE,SEX OFFENDER: PROHIBITED ZONE,2014,4,2,2
OTHER OFFENSE,SEX OFFENDER: PROHIBITED ZONE,2015,24,6,18
OTHER OFFENSE,SEX OFFENDER: PROHIBITED ZONE,2016,13,7,6
OTHER OFFENSE,SEX OFFENDER: PROHIBITED ZONE,2017,6,3,3
OTHER OFFENSE,SEX OFFENDER: PROHIBITED ZONE,2018,4,1,3
OTHER OFFENSE,TAMPER WITH MOTOR VEHICLE,2008,28,16,12
OTHER OFFENSE,TAMPER WITH MOTOR VEHICLE,2009,60,52,8
OTHER OFFENSE,TAMPER WITH MOTOR VEHICLE,2010,67,54,13
OTHER OFFENSE,TAMPER WITH MOTOR VEHICLE,2011,36,24,12
OTHER OFFENSE,TAMPER WITH MOTOR VEHICLE,2012,13,9,4
OTHER OFFENSE,TAMPER WITH MOTOR VEHICLE,2013,24,19,5
OTHER OFFENSE,TAMPER WITH MOTOR VEHICLE,2014,19,12,7
OTHER OFFENSE,TAMPER WITH MOTOR VEHICLE,2015,25,19,6
OTHER OFFENSE,TAMPER WITH MOTOR VEHICLE,2016,17,13,4
OTHER OFFENSE,TAMPER WITH MOTOR VEHICLE,2017,18,17,1
OTHER OFFENSE,TAMPER WITH MOTOR VEHICLE,2018,16,14,2
OTHER OFFENSE,TELEPHONE THREAT,2008,18738,18334,404
OTHER OFFENSE,TELEPHONE THREAT,2009,18030,17632,398
OTHER OFFENSE,TELEPHONE THREAT,2010,14648,14311,337
OTHER OFFENSE,TELEPHONE THREAT,2011,6743,6608,135
OTHER OFFENSE,TELEPHONE THREAT,2012,5538,5442,96
OTHER OFFENSE,TELEPHONE THREAT,2013,5016,4909,107
OTHER OFFENSE,TELEPHONE THREAT,2014,4221,4126,95
OTHER OFFENSE,TELEPHONE THREAT,2015,4193,4115,78
OTHER OFFENSE,TELEPHONE THREAT,2016,4048,3992,56
OTHER OFFENSE,TELEPHONE THREAT,2017,3891,3815,76
OTHER OFFENSE,TELEPHONE THREAT,2018,3655,3585,70
OTHER OFFENSE,UNLAWFUL USE OF BODY ARMOR,2008,2,0,2
OTHER OFFENSE,UNLAWFUL USE OF BODY ARMOR,2011,1,0,1
OTHER OFFENSE,UNLAWFUL USE OF BODY ARMOR,2013,1,0,1
OTHER OFFENSE,UNLAWFUL USE OF BODY ARMOR,2014,1,0,1
OTHER OFFENSE,UNLAWFUL USE OF BODY ARMOR,2018,3,0,3
OTHER OFFENSE,VEHICLE TITLE/REG OFFENSE,2008,880,380,500
OTHER OFFENSE,VEHICLE TITLE/REG OFFENSE,2009,1206,272,934
OTHER OFFENSE,VEHICLE TITLE/REG OFFENSE,2010,929,287,642
OTHER OFFENSE,VEHICLE TITLE/REG OFFENSE,2011,345,74,271
OTHER OFFENSE,VEHICLE TITLE/REG OFFENSE,2012,321,79,242
OTHER OFFENSE,VEHICLE TITLE/REG OFFENSE,2013,385,63,322
OTHER OFFENSE,VEHICLE TITLE/REG OFFENSE,2014,344,47,297
OTHER OFFENSE,VEHICLE TITLE/REG OFFENSE,2015,349,63,286
OTHER OFFENSE,VEHICLE TITLE/REG OFFENSE,2016,509,92,417
OTHER OFFENSE,VEHICLE TITLE/REG OFFENSE,2017,616,103,513
OTHER OFFENSE,VEHICLE TITLE/REG OFFENSE,2018,610,76,534
OTHER OFFENSE,VIO BAIL BOND: DOM VIOLENCE,2008,76,30,46
OTHER OFFENSE,VIO BAIL BOND: DOM VIOLENCE,2009,46,14,32
OTHER OFFENSE,VIO BAIL BOND: DOM VIOLENCE,2010,51,14,37
OTHER OFFENSE,VIO BAIL BOND: DOM VIOLENCE,2011,21,6,15
OTHER OFFENSE,VIO BAIL BOND: DOM VIOLENCE,2012,16,5,11
OTHER OFFENSE,VIO BAIL BOND: DOM VIOLENCE,2013,21,4,17
OTHER OFFENSE,VIO BAIL BOND: DOM VIOLENCE,2014,23,9,14
OTHER OFFENSE,VIO BAIL BOND: DOM VIOLENCE,2015,25,7,18
OTHER OFFENSE,VIO BAIL BOND: DOM VIOLENCE,2016,19,7,12
OTHER OFFENSE,VIO BAIL BOND: DOM VIOLENCE,2017,21,9,12
OTHER OFFENSE,VIO BAIL BOND: DOM VIOLENCE,2018,27,11,16
OTHER OFFENSE,VIOLATE ORDER OF PROTECTION,2008,3828,1950,1878
OTHER OFFENSE,VIOLATE ORDER OF PROTECTION,2009,3340,1558,1782
OTHER OFFENSE,VIOLATE ORDER OF PROTECTION,2010,3120,1807,1313
OTHER OFFENSE,VIOLATE ORDER OF PROTECTION,2011,1673,1001,672
OTHER OFFENSE,VIOLATE ORDER OF PROTECTION,2012,1661,968,693
OTHER OFFENSE,VIOLATE ORDER OF PROTECTION,2013,1389,790,599
OTHER OFFENSE,VIOLATE ORDER OF PROTECTION,2014,1253,656,597
OTHER OFFENSE,VIOLATE ORDER OF PROTECTION,2015,1542,843,699
OTHER OFFENSE,VIOLATE ORDER OF PROTECTION,2016,1580,1041,539
OTHER OFFENSE,VIOLATE ORDER OF PROTECTION,2017,1554,931,623
OTHER OFFENSE,VIOLATE ORDER OF PROTECTION,2018,1564,984,580
OTHER OFFENSE,VIOLATION GPS MONITORING DEVICE,2013,2,1,1
OTHER OFFENSE,VIOLATION GPS MONITORING DEVICE,2014,7,1,6
OTHER OFFENSE,VIOLATION GPS MONITORING DEVICE,2015,11,7,4
OTHER OFFENSE,VIOLATION GPS MONITORING DEVICE,2016,6,3,3
OTHER OFFENSE,VIOLATION GPS MONITORING DEVICE,2017,9,8,1
OTHER OFFENSE,VIOLATION GPS MONITORING DEVICE,2018,17,9,8
OTHER OFFENSE,VIOLATION OF CIVIL NO CONTACT ORDER,2014,17,15,2
OTHER OFFENSE,VIOLATION OF CIVIL NO CONTACT ORDER,2015,57,42,15
OTHER OFFENSE,VIOLATION OF CIVIL NO CONTACT ORDER,2016,65,53,12
OTHER OFFENSE,VIOLATION OF CIVIL NO CONTACT ORDER,2017,68,48,20
OTHER OFFENSE,VIOLATION OF CIVIL NO CONTACT ORDER,2018,86,68,18
OTHER OFFENSE,VIOLATION OF SMOKING BAN,2008,22,10,12
OTHER OFFENSE,VIOLATION OF SMOKING BAN,2009,6,4,2
OTHER OFFENSE,VIOLATION OF SMOKING BAN,2010,6,4,2
OTHER OFFENSE,VIOLATION OF SMOKING BAN,2011,2,1,1
OTHER OFFENSE,VIOLATION OF SMOKING BAN,2012,4,3,1
OTHER OFFENSE,VIOLATION OF SMOKING BAN,2013,3,2,1
OTHER OFFENSE,VIOLATION OF SMOKING BAN,2014,2,1,1
OTHER OFFENSE,VIOLATION OF SMOKING BAN,2016,1,0,1
OTHER OFFENSE,VIOLATION OF SMOKING BAN,2017,5,0,5
OTHER OFFENSE,VIOLATION OF SUMMARY CLOSURE,2015,1,0,1
OTHER OFFENSE,VIOLATION OF SUMMARY CLOSURE,2018,4,3,1
OTHER OFFENSE,VIOLENT OFFENDER: ANNUAL REGISTRATION,2014,20,1,19
OTHER OFFENSE,VIOLENT OFFENDER: ANNUAL REGISTRATION,2015,35,2,33
OTHER OFFENSE,VIOLENT OFFENDER: ANNUAL REGISTRATION,2016,31,9,22
OTHER OFFENSE,VIOLENT OFFENDER: ANNUAL REGISTRATION,2017,46,11,35
OTHER OFFENSE,VIOLENT OFFENDER: ANNUAL REGISTRATION,2018,45,5,40
OTHER OFFENSE,VIOLENT OFFENDER: DUTY TO REGISTER,2014,3,1,2
OTHER OFFENSE,VIOLENT OFFENDER: DUTY TO REGISTER,2015,6,2,4
OTHER OFFENSE,VIOLENT OFFENDER: DUTY TO REGISTER,2016,13,6,7
OTHER OFFENSE,VIOLENT OFFENDER: DUTY TO REGISTER,2017,36,6,30
OTHER OFFENSE,VIOLENT OFFENDER: DUTY TO REGISTER,2018,22,5,17
OTHER OFFENSE,VIOLENT OFFENDER: FAIL TO REGISTER NEW ADDRESS,2014,1,0,1
OTHER OFFENSE,VIOLENT OFFENDER: FAIL TO REGISTER NEW ADDRESS,2015,5,2,3
OTHER OFFENSE,VIOLENT OFFENDER: FAIL TO REGISTER NEW ADDRESS,2016,8,3,5
OTHER OFFENSE,VIOLENT OFFENDER: FAIL TO REGISTER NEW ADDRESS,2017,10,3,7
OTHER OFFENSE,VIOLENT OFFENDER: FAIL TO REGISTER NEW ADDRESS,2018,13,5,8
PROSTITUTION,CAB OPERATION,2008,6,2,4
PROSTITUTION,CAB OPERATION,2010,2,0,2
PROSTITUTION,CAB OPERATION,2017,1,0,1
PROSTITUTION,CALL OPERATION,2008,522,12,510
PROSTITUTION,CALL OPERATION,2009,572,6,566
PROSTITUTION,CALL OPERATION,2010,339,0,339
PROSTITUTION,CALL OPERATION,2011,180,0,180
PROSTITUTION,CALL OPERATION,2012,129,3,126
PROSTITUTION,CALL OPERATION,2013,115,1,114
PROSTITUTION,CALL OPERATION,2014,127,8,119
PROSTITUTION,CALL OPERATION,2015,129,0,129
PROSTITUTION,CALL OPERATION,2016,18,0,18
PROSTITUTION,CALL OPERATION,2017,29,0,29
PROSTITUTION,CALL OPERATION,2018,3,0,3
PROSTITUTION,IN TAVERN,2008,8,0,8
PROSTITUTION,IN TAVERN,2009,2,0,2
PROSTITUTION,IN TAVERN,2012,1,0,1
PROSTITUTION,IN TAVERN,2015,1,0,1
PROSTITUTION,JUVENILE PIMPING,2008,2,0,2
PROSTITUTION,JUVENILE PIMPING,2009,10,0,10
PROSTITUTION,JUVENILE PIMPING,2010,4,0,4
PROSTITUTION,JUVENILE PIMPING,2011,1,0,1
PROSTITUTION,JUVENILE PIMPING,2012,1,0,1
PROSTITUTION,KEEP PLACE OF PROSTITUTION,2008,8,0,8
PROSTITUTION,KEEP PLACE OF PROSTITUTION,2009,10,0,10
PROSTITUTION,KEEP PLACE OF PROSTITUTION,2010,24,0,24
PROSTITUTION,KEEP PLACE OF PROSTITUTION,2011,3,0,3
PROSTITUTION,KEEP PLACE OF PROSTITUTION,2012,8,0,8
PROSTITUTION,KEEP PLACE OF PROSTITUTION,2013,11,0,11
PROSTITUTION,KEEP PLACE OF PROSTITUTION,2014,1,0,1
PROSTITUTION,KEEP PLACE OF PROSTITUTION,2016,1,0,1
PROSTITUTION,KEEP PLACE OF PROSTITUTION,2017,2,0,2
PROSTITUTION,OTHER PROSTITUTION OFFENSE,2008,10,0,10
PROSTITUTION,OTHER PROSTITUTION OFFENSE,2009,142,0,142
PROSTITUTION,OTHER PROSTITUTION OFFENSE,2010,89,0,89
PROSTITUTION,OTHER PROSTITUTION OFFENSE,2011,16,2,14
PROSTITUTION,OTHER PROSTITUTION OFFENSE,2012,8,0,8
PROSTITUTION,OTHER PROSTITUTION OFFENSE,2013,4,0,4
PROSTITUTION,OTHER PROSTITUTION OFFENSE,2014,56,0,56
PROSTITUTION,OTHER PROSTITUTION OFFENSE,2015,7,0,7
PROSTITUTION,OTHER PROSTITUTION OFFENSE,2016,3,0,3
PROSTITUTION,OTHER PROSTITUTION OFFENSE,2017,4,0,4
PROSTITUTION,OTHER PROSTITUTION OFFENSE,2018,6,0,6
PROSTITUTION,PANDERING,2008,14,0,14
PROSTITUTION,PANDERING,2009,24,0,24
PROSTITUTION,PANDERING,2010,7,0,7
PROSTITUTION,PANDERING,2011,2,0,2
PROSTITUTION,PANDERING,2013,1,0,1
PROSTITUTION,PANDERING,2015,1,0,1
PROSTITUTION,PANDERING,2016,2,0,2
PROSTITUTION,PANDERING,2017,1,0,1
PROSTITUTION,PATRONIZE JUVENILE PROSTITUTE,2011,2,0,2
PROSTITUTION,PATRONIZE JUVENILE PROSTITUTE,2015,3,0,3
PROSTITUTION,PATRONIZING A PROSTITUTE,2008,86,0,86
PROSTITUTION,PATRONIZING A PROSTITUTE,2009,48,0,48
PROSTITUTION,PATRONIZING A PROSTITUTE,2010,42,0,42
PROSTITUTION,PATRONIZING A PROSTITUTE,2011,23,0,23
PROSTITUTION,PATRONIZING A PROSTITUTE,2012,15,0,15
PROSTITUTION,PATRONIZING A PROSTITUTE,2013,11,0,11
PROSTITUTION,PATRONIZING A PROSTITUTE,2014,12,0,12
PROSTITUTION,PATRONIZING A PROSTITUTE,2015,4,0,4
PROSTITUTION,PATRONIZING A PROSTITUTE,2017,1,0,1
PROSTITUTION,PIMPING,2008,12,0,12
PROSTITUTION,PIMPING,2009,10,0,10
PROSTITUTION,PIMPING,2010,3,1,2
PROSTITUTION,PIMPING,2011,11,1,10
PROSTITUTION,PIMPING,2012,2,0,2
PROSTITUTION,PIMPING,2013,1,0,1
PROSTITUTION,PIMPING,2015,2,0,2
PROSTITUTION,PIMPING,2018,1,0,1
PROSTITUTION,SOLICIT FOR BUSINESS,2008,2284,8,2276
PROSTITUTION,SOLICIT FOR BUSINESS,2009,1406,0,1406
PROSTITUTION,SOLICIT FOR BUSINESS,2010,906,1,905
PROSTITUTION,SOLICIT FOR BUSINESS,2011,452,0,452
PROSTITUTION,SOLICIT FOR BUSINESS,2012,312,5,307
PROSTITUTION,SOLICIT FOR BUSINESS,2013,153,0,153
PROSTITUTION,SOLICIT FOR BUSINESS,2014,244,1,243
PROSTITUTION,SOLICIT FOR BUSINESS,2015,159,0,159
PROSTITUTION,SOLICIT FOR BUSINESS,2016,14,0,14
PROSTITUTION,SOLICIT FOR BUSINESS,2017,37,0,37
PROSTITUTION,SOLICIT FOR BUSINESS,2018,80,0,80
PROSTITUTION,SOLICIT FOR PROSTITUTE,2008,188,2,186
PROSTITUTION,SOLICIT FOR PROSTITUTE,2009,124,0,124
PROSTITUTION,SOLICIT FOR PROSTITUTE,2010,367,0,367
PROSTITUTION,SOLICIT FOR PROSTITUTE,2011,396,0,396
PROSTITUTION,SOLICIT FOR PROSTITUTE,2012,384,2,382
PROSTITUTION,SOLICIT FOR PROSTITUTE,2013,251,0,251
PROSTITUTION,SOLICIT FOR PROSTITUTE,2014,98,1,97
PROSTITUTION,SOLICIT FOR PROSTITUTE,2015,90,0,90
PROSTITUTION,SOLICIT FOR PROSTITUTE,2016,27,0,27
PROSTITUTION,SOLICIT FOR PROSTITUTE,2017,21,0,21
PROSTITUTION,SOLICIT FOR PROSTITUTE,2018,26,0,26
PROSTITUTION,SOLICIT OFF PUBLIC WAY,2008,42,0,42
PROSTITUTION,SOLICIT OFF PUBLIC WAY,2009,22,0,22
PROSTITUTION,SOLICIT OFF PUBLIC WAY,2010,10,0,10
PROSTITUTION,SOLICIT OFF PUBLIC WAY,2011,8,0,8
PROSTITUTION,SOLICIT OFF PUBLIC WAY,2012,10,0,10
PROSTITUTION,SOLICIT OFF PUBLIC WAY,2013,4,0,4
PROSTITUTION,SOLICIT OFF PUBLIC WAY,2014,5,0,5
PROSTITUTION,SOLICIT OFF PUBLIC WAY,2015,11,0,11
PROSTITUTION,SOLICIT OFF PUBLIC WAY,2016,4,0,4
PROSTITUTION,SOLICIT OFF PUBLIC WAY,2017,2,0,2
PROSTITUTION,SOLICIT OFF PUBLIC WAY,2018,5,0,5
PROSTITUTION,SOLICIT ON PUBLIC WAY,2008,6996,90,6906
PROSTITUTION,SOLICIT ON PUBLIC WAY,2009,5430,16,5414
PROSTITUTION,SOLICIT ON PUBLIC WAY,2010,2850,3,2847
PROSTITUTION,SOLICIT ON PUBLIC WAY,2011,1330,2,1328
PROSTITUTION,SOLICIT ON PUBLIC WAY,2012,1333,5,1328
PROSTITUTION,SOLICIT ON PUBLIC WAY,2013,1100,3,1097
PROSTITUTION,SOLICIT ON PUBLIC WAY,2014,1074,3,1071
PROSTITUTION,SOLICIT ON PUBLIC WAY,2015,909,2,907
PROSTITUTION,SOLICIT ON PUBLIC WAY,2016,711,0,711
PROSTITUTION,SOLICIT ON PUBLIC WAY,2017,636,0,636
PROSTITUTION,SOLICIT ON PUBLIC WAY,2018,553,0,553
PUBLIC INDECENCY,LICENSED PREMISE,2008,8,2,6
PUBLIC INDECENCY,LICENSED PREMISE,2009,20,0,20
PUBLIC INDECENCY,LICENSED PREMISE,2010,13,0,13
PUBLIC INDECENCY,LICENSED PREMISE,2011,13,0,13
PUBLIC INDECENCY,LICENSED PREMISE,2012,17,0,17
PUBLIC INDECENCY,LICENSED PREMISE,2013,10,0,10
PUBLIC INDECENCY,LICENSED PREMISE,2014,10,0,10
PUBLIC INDECENCY,LICENSED PREMISE,2015,14,0,14
PUBLIC INDECENCY,LICENSED PREMISE,2016,10,0,10
PUBLIC INDECENCY,LICENSED PREMISE,2017,10,0,10
PUBLIC INDECENCY,LICENSED PREMISE,2018,14,0,14
PUBLIC PEACE VIOLATION,ARSON THREAT,2008,658,598,60
PUBLIC PEACE VIOLATION,ARSON THREAT,2009,478,408,70
PUBLIC PEACE VIOLATION,ARSON THREAT,2010,374,327,47
PUBLIC PEACE VIOLATION,ARSON THREAT,2011,145,123,22
PUBLIC PEACE VIOLATION,ARSON THREAT,2012,157,141,16
PUBLIC PEACE VIOLATION,ARSON THREAT,2013,158,142,16
PUBLIC PEACE VIOLATION,ARSON THREAT,2014,111,106,5
PUBLIC PEACE VIOLATION,ARSON THREAT,2015,92,82,10
PUBLIC PEACE VIOLATION,ARSON THREAT,2016,80,72,8
PUBLIC PEACE VIOLATION,ARSON THREAT,2017,80,74,6
PUBLIC PEACE VIOLATION,ARSON THREAT,2018,97,92,5
PUBLIC PEACE VIOLATION,BOMB THREAT,2008,780,700,80
PUBLIC PEACE VIOLATION,BOMB THREAT,2009,470,438,32
PUBLIC PEACE VIOLATION,BOMB THREAT,2010,344,308,36
PUBLIC PEACE VIOLATION,BOMB THREAT,2011,180,162,18
PUBLIC PEACE VIOLATION,BOMB THREAT,2012,168,156,12
PUBLIC PEACE VIOLATION,BOMB THREAT,2013,191,171,20
PUBLIC PEACE VIOLATION,BOMB THREAT,2014,127,109,18
PUBLIC PEACE VIOLATION,BOMB THREAT,2015,121,117,4
PUBLIC PEACE VIOLATION,BOMB THREAT,2016,121,117,4
PUBLIC PEACE VIOLATION,BOMB THREAT,2017,134,129,5
PUBLIC PEACE VIOLATION,BOMB THREAT,2018,114,108,6
PUBLIC PEACE VIOLATION,FALSE FIRE ALARM,2008,170,112,58
PUBLIC PEACE VIOLATION,FALSE FIRE ALARM,2009,146,100,46
PUBLIC PEACE VIOLATION,FALSE FIRE ALARM,2010,201,125,76
PUBLIC PEACE VIOLATION,FALSE FIRE ALARM,2011,45,21,24
PUBLIC PEACE VIOLATION,FALSE FIRE ALARM,2012,50,30,20
PUBLIC PEACE VIOLATION,FALSE FIRE ALARM,2013,32,11,21
PUBLIC PEACE VIOLATION,FALSE FIRE ALARM,2014,26,14,12
PUBLIC PEACE VIOLATION,FALSE FIRE ALARM,2015,22,10,12
PUBLIC PEACE VIOLATION,FALSE FIRE ALARM,2016,19,10,9
PUBLIC PEACE VIOLATION,FALSE FIRE ALARM,2017,18,10,8
PUBLIC PEACE VIOLATION,FALSE FIRE ALARM,2018,9,3,6
PUBLIC PEACE VIOLATION,FALSE POLICE REPORT,2008,264,90,174
PUBLIC PEACE VIOLATION,FALSE POLICE REPORT,2009,264,76,188
PUBLIC PEACE VIOLATION,FALSE POLICE REPORT,2010,280,64,216
PUBLIC PEACE VIOLATION,FALSE POLICE REPORT,2011,141,40,101
PUBLIC PEACE VIOLATION,FALSE POLICE REPORT,2012,105,20,85
PUBLIC PEACE VIOLATION,FALSE POLICE REPORT,2013,127,45,82
PUBLIC PEACE VIOLATION,FALSE POLICE REPORT,2014,117,35,82
PUBLIC PEACE VIOLATION,FALSE POLICE REPORT,2015,108,39,69
PUBLIC PEACE VIOLATION,FALSE POLICE REPORT,2016,50,27,23
PUBLIC PEACE VIOLATION,FALSE POLICE REPORT,2017,59,28,31
PUBLIC PEACE VIOLATION,FALSE POLICE REPORT,2018,77,32,45
PUBLIC PEACE VIOLATION,INTERFERE W/ EMERGENCY EQUIP,2009,2,0,2
PUBLIC PEACE VIOLATION,INTERFERE W/ EMERGENCY EQUIP,2010,6,4,2
PUBLIC PEACE VIOLATION,INTERFERE W/ EMERGENCY EQUIP,2018,3,2,1
PUBLIC PEACE VIOLATION,MOB ACTION,2008,296,50,246
PUBLIC PEACE VIOLATION,MOB ACTION,2009,318,44,274
PUBLIC PEACE VIOLATION,MOB ACTION,2010,226,46,180
PUBLIC PEACE VIOLATION,MOB ACTION,2011,99,25,74
PUBLIC PEACE VIOLATION,MOB ACTION,2012,77,12,65
PUBLIC PEACE VIOLATION,MOB ACTION,2013,107,15,92
PUBLIC PEACE VIOLATION,MOB ACTION,2014,57,5,52
PUBLIC PEACE VIOLATION,MOB ACTION,2015,32,4,28
PUBLIC PEACE VIOLATION,MOB ACTION,2016,24,7,17
PUBLIC PEACE VIOLATION,MOB ACTION,2017,5,0,5
PUBLIC PEACE VIOLATION,MOB ACTION,2018,9,2,7
PUBLIC PEACE VIOLATION,OTHER VIOLATION,2008,164,96,68
PUBLIC PEACE VIOLATION,OTHER VIOLATION,2009,250,100,150
PUBLIC PEACE VIOLATION,OTHER VIOLATION,2010,340,181,159
PUBLIC PEACE VIOLATION,OTHER VIOLATION,2011,145,53,92
PUBLIC PEACE VIOLATION,OTHER VIOLATION,2012,128,39,89
PUBLIC PEACE VIOLATION,OTHER VIOLATION,2013,115,38,77
PUBLIC PEACE VIOLATION,OTHER VIOLATION,2014,119,22,97
PUBLIC PEACE VIOLATION,OTHER VIOLATION,2015,106,37,69
PUBLIC PEACE VIOLATION,OTHER VIOLATION,2016,90,28,62
PUBLIC PEACE VIOLATION,OTHER VIOLATION,2017,111,45,66
PUBLIC PEACE VIOLATION,OTHER VIOLATION,2018,93,43,50
PUBLIC PEACE VIOLATION,PEEPING TOM,2008,106,78,28
PUBLIC PEACE VIOLATION,PEEPING TOM,2009,76,64,12
PUBLIC PEACE VIOLATION,PEEPING TOM,2010,109,85,24
PUBLIC PEACE VIOLATION,PEEPING TOM,2011,50,38,12
PUBLIC PEACE VIOLATION,PEEPING TOM,2012,48,41,7
PUBLIC PEACE VIOLATION,PEEPING TOM,2013,34,26,8
PUBLIC PEACE VIOLATION,PEEPING TOM,2014,42,25,17
PUBLIC PEACE VIOLATION,PEEPING TOM,2015,41,31,10
PUBLIC PEACE VIOLATION,PEEPING TOM,2016,40,36,4
PUBLIC PEACE VIOLATION,PEEPING TOM,2017,44,38,6
PUBLIC PEACE VIOLATION,PEEPING TOM,2018,46,42,4
PUBLIC PEACE VIOLATION,PUBLIC DEMONSTRATION,2008,4,2,2
PUBLIC PEACE VIOLATION,PUBLIC DEMONSTRATION,2009,4,2,2
PUBLIC PEACE VIOLATION,PUBLIC DEMONSTRATION,2010,18,16,2
PUBLIC PEACE VIOLATION,PUBLIC DEMONSTRATION,2011,7,3,4
PUBLIC PEACE VIOLATION,PUBLIC DEMONSTRATION,2012,5,2,3
PUBLIC PEACE VIOLATION,PUBLIC DEMONSTRATION,2013,5,2,3
PUBLIC PEACE VIOLATION,PUBLIC DEMONSTRATION,2014,9,3,6
PUBLIC PEACE VIOLATION,PUBLIC DEMONSTRATION,2015,20,14,6
PUBLIC PEACE VIOLATION,PUBLIC DEMONSTRATION,2016,19,8,11
PUBLIC PEACE VIOLATION,PUBLIC DEMONSTRATION,2017,9,3,6
PUBLIC PEACE VIOLATION,RECKLESS CONDUCT,2008,3536,722,2814
PUBLIC PEACE VIOLATION,RECKLESS CONDUCT,2009,4229,466,3763
PUBLIC PEACE VIOLATION,RECKLESS CONDUCT,2010,4896,764,4132
PUBLIC PEACE VIOLATION,RECKLESS CONDUCT,2011,2281,231,2050
PUBLIC PEACE VIOLATION,RECKLESS CONDUCT,2012,2261,314,1947
PUBLIC PEACE VIOLATION,RECKLESS CONDUCT,2013,2359,353,2006
PUBLIC PEACE VIOLATION,RECKLESS CONDUCT,2014,2275,219,2056
PUBLIC PEACE VIOLATION,RECKLESS CONDUCT,2015,1865,195,1670
PUBLIC PEACE VIOLATION,RECKLESS CONDUCT,2016,1133,166,967
PUBLIC PEACE VIOLATION,RECKLESS CONDUCT,2017,1032,146,886
PUBLIC PEACE VIOLATION,RECKLESS CONDUCT,2018,789,138,651
PUBLIC PEACE VIOLATION,SELL/ADVERTISE FIREWORKS,2008,2,0,2
PUBLIC PEACE VIOLATION,SELL/ADVERTISE FIREWORKS,2009,6,0,6
PUBLIC PEACE VIOLATION,SELL/ADVERTISE FIREWORKS,2010,14,8,6
PUBLIC PEACE VIOLATION,SELL/ADVERTISE FIREWORKS,2011,2,0,2
PUBLIC PEACE VIOLATION,SELL/ADVERTISE FIREWORKS,2012,6,0,6
PUBLIC PEACE VIOLATION,SELL/ADVERTISE FIREWORKS,2013,5,0,5
PUBLIC PEACE VIOLATION,SELL/ADVERTISE FIREWORKS,2015,2,1,1
PUBLIC PEACE VIOLATION,SELL/ADVERTISE FIREWORKS,2016,2,1,1
PUBLIC PEACE VIOLATION,SELL/ADVERTISE FIREWORKS,2017,2,0,2
ROBBERY,AGGRAVATED,2008,1788,1460,328
ROBBERY,AGGRAVATED,2009,1679,1423,256
ROBBERY,AGGRAVATED,2010,1323,1129,194
ROBBERY,AGGRAVATED,2011,714,617,97
ROBBERY,AGGRAVATED,2012,706,609,97
ROBBERY,AGGRAVATED,2013,689,566,123
ROBBERY,AGGRAVATED,2014,574,477,97
ROBBERY,AGGRAVATED,2015,510,426,84
ROBBERY,AGGRAVATED,2016,667,589,78
ROBBERY,AGGRAVATED,2017,734,639,95
ROBBERY,AGGRAVATED,2018,536,479,57
ROBBERY,AGGRAVATED VEHICULAR HIJACKING,2008,1024,926,98
ROBBERY,AGGRAVATED VEHICULAR HIJACKING,2009,884,768,116
ROBBERY,AGGRAVATED VEHICULAR HIJACKING,2010,619,552,67
ROBBERY,AGGRAVATED VEHICULAR HIJACKING,2011,317,285,32
ROBBERY,AGGRAVATED VEHICULAR HIJACKING,2012,312,278,34
ROBBERY,AGGRAVATED VEHICULAR HIJACKING,2013,201,171,30
ROBBERY,AGGRAVATED VEHICULAR HIJACKING,2014,179,160,19
ROBBERY,AGGRAVATED VEHICULAR HIJACKING,2015,189,173,16
ROBBERY,AGGRAVATED VEHICULAR HIJACKING,2016,385,365,20
ROBBERY,AGGRAVATED VEHICULAR HIJACKING,2017,563,514,49
ROBBERY,AGGRAVATED VEHICULAR HIJACKING,2018,421,383,38
ROBBERY,ARMED: HANDGUN,2008,12236,11418,818
ROBBERY,ARMED: HANDGUN,2009,11831,11052,779
ROBBERY,ARMED: HANDGUN,2010,8991,8431,560
ROBBERY,ARMED: HANDGUN,2011,4862,4564,298
ROBBERY,ARMED: HANDGUN,2012,4883,4511,372
ROBBERY,ARMED: HANDGUN,2013,4028,3774,254
ROBBERY,ARMED: HANDGUN,2014,3417,3198,219
ROBBERY,ARMED: HANDGUN,2015,3708,3491,217
ROBBERY,ARMED: HANDGUN,2016,4649,4459,190
ROBBERY,ARMED: HANDGUN,2017,4546,4319,227
ROBBERY,ARMED: HANDGUN,2018,3263,3084,179
ROBBERY,ARMED: OTHER DANGEROUS WEAPON,2008,1518,1364,154
ROBBERY,ARMED: OTHER DANGEROUS WEAPON,2009,1458,1324,134
ROBBERY,ARMED: OTHER DANGEROUS WEAPON,2010,1227,1119,108
ROBBERY,ARMED: OTHER DANGEROUS WEAPON,2011,635,570,65
ROBBERY,ARMED: OTHER DANGEROUS WEAPON,2012,586,530,56
ROBBERY,ARMED: OTHER DANGEROUS WEAPON,2013,520,462,58
ROBBERY,ARMED: OTHER DANGEROUS WEAPON,2014,480,440,40
ROBBERY,ARMED: OTHER DANGEROUS WEAPON,2015,460,420,40
ROBBERY,ARMED: OTHER DANGEROUS WEAPON,2016,468,424,44
ROBBERY,ARMED: OTHER DANGEROUS WEAPON,2017,477,432,45
ROBBERY,ARMED: OTHER DANGEROUS WEAPON,2018,383,351,32
ROBBERY,ARMED: OTHER FIREARM,2008,220,194,26
ROBBERY,ARMED: OTHER FIREARM,2009,182,162,20
ROBBERY,ARMED: OTHER FIREARM,2010,154,144,10
ROBBERY,ARMED: OTHER FIREARM,2011,105,93,12
ROBBERY,ARMED: OTHER FIREARM,2012,83,65,18
ROBBERY,ARMED: OTHER FIREARM,2013,51,41,10
ROBBERY,ARMED: OTHER FIREARM,2014,46,40,6
ROBBERY,ARMED: OTHER FIREARM,2015,45,41,4
ROBBERY,ARMED: OTHER FIREARM,2016,60,53,7
ROBBERY,ARMED: OTHER FIREARM,2017,57,54,3
ROBBERY,ARMED:KNIFE/CUTTING INSTRUMENT,2008,1488,1350,138
ROBBERY,ARMED:KNIFE/CUTTING INSTRUMENT,2009,1260,1114,146
ROBBERY,ARMED:KNIFE/CUTTING INSTRUMENT,2010,1102,1006,96
ROBBERY,ARMED:KNIFE/CUTTING INSTRUMENT,2011,540,480,60
ROBBERY,ARMED:KNIFE/CUTTING INSTRUMENT,2012,537,480,57
ROBBERY,ARMED:KNIFE/CUTTING INSTRUMENT,2013,509,462,47
ROBBERY,ARMED:KNIFE/CUTTING INSTRUMENT,2014,353,318,35
ROBBERY,ARMED:KNIFE/CUTTING INSTRUMENT,2015,413,351,62
ROBBERY,ARMED:KNIFE/CUTTING INSTRUMENT,2016,475,434,41
ROBBERY,ARMED:KNIFE/CUTTING INSTRUMENT,2017,522,449,73
ROBBERY,ARMED:KNIFE/CUTTING INSTRUMENT,2018,447,395,52
ROBBERY,ATTEMPT: AGGRAVATED,2008,180,134,46
ROBBERY,ATTEMPT: AGGRAVATED,2009,158,116,42
ROBBERY,ATTEMPT: AGGRAVATED,2010,137,108,29
ROBBERY,ATTEMPT: AGGRAVATED,2011,68,50,18
ROBBERY,ATTEMPT: AGGRAVATED,2012,70,50,20
ROBBERY,ATTEMPT: AGGRAVATED,2013,54,38,16
ROBBERY,ATTEMPT: AGGRAVATED,2014,57,41,16
ROBBERY,ATTEMPT: AGGRAVATED,2015,54,41,13
ROBBERY,ATTEMPT: AGGRAVATED,2016,79,62,17
ROBBERY,ATTEMPT: AGGRAVATED,2017,80,62,18
ROBBERY,ATTEMPT: AGGRAVATED,2018,50,40,10
ROBBERY,ATTEMPT: ARMED-HANDGUN,2008,1032,916,116
ROBBERY,ATTEMPT: ARMED-HANDGUN,2009,1143,1031,112
ROBBERY,ATTEMPT: ARMED-HANDGUN,2010,815,757,58
ROBBERY,ATTEMPT: ARMED-HANDGUN,2011,420,389,31
ROBBERY,ATTEMPT: ARMED-HANDGUN,2012,412,364,48
ROBBERY,ATTEMPT: ARMED-HANDGUN,2013,315,283,32
ROBBERY,ATTEMPT: ARMED-HANDGUN,2014,284,255,29
ROBBERY,ATTEMPT: ARMED-HANDGUN,2015,285,255,30
ROBBERY,ATTEMPT: ARMED-HANDGUN,2016,428,394,34
ROBBERY,ATTEMPT: ARMED-HANDGUN,2017,403,369,34
ROBBERY,ATTEMPT: ARMED-HANDGUN,2018,303,282,21
ROBBERY,ATTEMPT: ARMED-KNIFE/CUT INSTR,2008,288,244,44
ROBBERY,ATTEMPT: ARMED-KNIFE/CUT INSTR,2009,252,230,22
ROBBERY,ATTEMPT: ARMED-KNIFE/CUT INSTR,2010,206,188,18
ROBBERY,ATTEMPT: ARMED-KNIFE/CUT INSTR,2011,118,105,13
ROBBERY,ATTEMPT: ARMED-KNIFE/CUT INSTR,2012,100,90,10
ROBBERY,ATTEMPT: ARMED-KNIFE/CUT INSTR,2013,100,81,19
ROBBERY,ATTEMPT: ARMED-KNIFE/CUT INSTR,2014,69,64,5
ROBBERY,ATTEMPT: ARMED-KNIFE/CUT INSTR,2015,75,68,7
ROBBERY,ATTEMPT: ARMED-KNIFE/CUT INSTR,2016,95,88,7
ROBBERY,ATTEMPT: ARMED-KNIFE/CUT INSTR,2017,108,96,12
ROBBERY,ATTEMPT: ARMED-KNIFE/CUT INSTR,2018,88,77,11
ROBBERY,ATTEMPT: ARMED-OTHER DANG WEAP,2008,268,214,54
ROBBERY,ATTEMPT: ARMED-OTHER DANG WEAP,2009,228,198,30
ROBBERY,ATTEMPT: ARMED-OTHER DANG WEAP,2010,215,194,21
ROBBERY,ATTEMPT: ARMED-OTHER DANG WEAP,2011,87,72,15
ROBBERY,ATTEMPT: ARMED-OTHER DANG WEAP,2012,80,70,10
ROBBERY,ATTEMPT: ARMED-OTHER DANG WEAP,2013,73,63,10
ROBBERY,ATTEMPT: ARMED-OTHER DANG WEAP,2014,76,66,10
ROBBERY,ATTEMPT: ARMED-OTHER DANG WEAP,2015,49,42,7
ROBBERY,ATTEMPT: ARMED-OTHER DANG WEAP,2016,60,55,5
ROBBERY,ATTEMPT: ARMED-OTHER DANG WEAP,2017,57,52,5
ROBBERY,ATTEMPT: ARMED-OTHER DANG WEAP,2018,58,55,3
ROBBERY,ATTEMPT: ARMED-OTHER FIREARM,2008,36,24,12
ROBBERY,ATTEMPT: ARMED-OTHER FIREARM,2009,50,42,8
ROBBERY,ATTEMPT: ARMED-OTHER FIREARM,2011,13,12,1
ROBBERY,ATTEMPT: ARMED-OTHER FIREARM,2012,16,14,2
ROBBERY,ATTEMPT: ARMED-OTHER FIREARM,2013,15,12,3
ROBBERY,ATTEMPT: ARMED-OTHER FIREARM,2014,8,7,1
ROBBERY,ATTEMPT: ARMED-OTHER FIREARM,2015,8,6,2
ROBBERY,ATTEMPT: ARMED-OTHER FIREARM,2017,13,11,2
ROBBERY,ATTEMPT: STRONGARM-NO WEAPON,2008,1308,1098,210
ROBBERY,ATTEMPT: STRONGARM-NO WEAPON,2009,1202,996,206
ROBBERY,ATTEMPT: STRONGARM-NO WEAPON,2010,1106,968,138
ROBBERY,ATTEMPT: STRONGARM-NO WEAPON,2011,538,468,70
ROBBERY,ATTEMPT: STRONGARM-NO WEAPON,2012,506,423,83
ROBBERY,ATTEMPT: STRONGARM-NO WEAPON,2013,499,402,97
ROBBERY,ATTEMPT: STRONGARM-NO WEAPON,2014,368,301,67
ROBBERY,ATTEMPT: STRONGARM-NO WEAPON,2015,344,298,46
ROBBERY,ATTEMPT: STRONGARM-NO WEAPON,2016,365,333,32
ROBBERY,ATTEMPT: STRONGARM-NO WEAPON,2017,373,333,40
ROBBERY,ATTEMPT: STRONGARM-NO WEAPON,2018,300,269,31
ROBBERY,STRONGARM - NO WEAPON,2008,11252,9992,1260
ROBBERY,STRONGARM - NO WEAPON,2009,10784,9606,1178
ROBBERY,STRONGARM - NO WEAPON,2010,10459,9207,1252
ROBBERY,STRONGARM - NO WEAPON,2011,5327,4742,585
ROBBERY,STRONGARM - NO WEAPON,2012,5017,4459,558
ROBBERY,STRONGARM - NO WEAPON,2013,4588,3984,604
ROBBERY,STRONGARM - NO WEAPON,2014,3618,3148,470
ROBBERY,STRONGARM - NO WEAPON,2015,3284,2939,345
ROBBERY,STRONGARM - NO WEAPON,2016,3607,3306,301
ROBBERY,STRONGARM - NO WEAPON,2017,3563,3280,283
ROBBERY,STRONGARM - NO WEAPON,2018,2862,2654,208
ROBBERY,VEHICULAR HIJACKING,2008,542,496,46
ROBBERY,VEHICULAR HIJACKING,2009,580,526,54
ROBBERY,VEHICULAR HIJACKING,2010,454,415,39
ROBBERY,VEHICULAR HIJACKING,2011,236,212,24
ROBBERY,VEHICULAR HIJACKING,2012,175,158,17
ROBBERY,VEHICULAR HIJACKING,2013,143,121,22
ROBBERY,VEHICULAR HIJACKING,2014,118,100,18
ROBBERY,VEHICULAR HIJACKING,2015,146,126,20
ROBBERY,VEHICULAR HIJACKING,2016,259,231,28
ROBBERY,VEHICULAR HIJACKING,2017,374,350,24
ROBBERY,VEHICULAR HIJACKING,2018,277,249,28
SEX OFFENSE,AGG CRIMINAL SEXUAL ABUSE,2008,634,488,146
SEX OFFENSE,AGG CRIMINAL SEXUAL ABUSE,2009,478,368,110
SEX OFFENSE,AGG CRIMINAL SEXUAL ABUSE,2010,383,300,83
SEX OFFENSE,AGG CRIMINAL SEXUAL ABUSE,2011,223,166,57
SEX OFFENSE,AGG CRIMINAL SEXUAL ABUSE,2012,205,154,51
SEX OFFENSE,AGG CRIMINAL SEXUAL ABUSE,2013,183,135,48
SEX OFFENSE,AGG CRIMINAL SEXUAL ABUSE,2014,166,135,31
SEX OFFENSE,AGG CRIMINAL SEXUAL ABUSE,2015,182,145,37
SEX OFFENSE,AGG CRIMINAL SEXUAL ABUSE,2016,122,102,20
SEX OFFENSE,AGG CRIMINAL SEXUAL ABUSE,2017,173,145,28
SEX OFFENSE,AGG CRIMINAL SEXUAL ABUSE,2018,182,165,17
SEX OFFENSE,ATT AGG CRIMINAL SEXUAL ABUSE,2009,12,10,2
SEX OFFENSE,ATT AGG CRIMINAL SEXUAL ABUSE,2010,16,10,6
SEX OFFENSE,ATT AGG CRIMINAL SEXUAL ABUSE,2011,5,2,3
SEX OFFENSE,ATT AGG CRIMINAL SEXUAL ABUSE,2012,14,11,3
SEX OFFENSE,ATT AGG CRIMINAL SEXUAL ABUSE,2013,4,3,1
SEX OFFENSE,ATT AGG CRIMINAL SEXUAL ABUSE,2015,9,5,4
SEX OFFENSE,ATT AGG CRIMINAL SEXUAL ABUSE,2017,12,9,3
SEX OFFENSE,ATT AGG CRIMINAL SEXUAL ABUSE,2018,7,5,2
SEX OFFENSE,ATT CRIM SEXUAL ABUSE,2008,100,82,18
SEX OFFENSE,ATT CRIM SEXUAL ABUSE,2009,108,90,18
SEX OFFENSE,ATT CRIM SEXUAL ABUSE,2010,63,51,12
SEX OFFENSE,ATT CRIM SEXUAL ABUSE,2011,30,22,8
SEX OFFENSE,ATT CRIM SEXUAL ABUSE,2012,26,24,2
SEX OFFENSE,ATT CRIM SEXUAL ABUSE,2013,27,23,4
SEX OFFENSE,ATT CRIM SEXUAL ABUSE,2014,30,28,2
SEX OFFENSE,ATT CRIM SEXUAL ABUSE,2015,29,27,2
SEX OFFENSE,ATT CRIM SEXUAL ABUSE,2016,25,23,2
SEX OFFENSE,ATT CRIM SEXUAL ABUSE,2017,33,30,3
SEX OFFENSE,CRIMINAL SEXUAL ABUSE,2008,968,748,220
SEX OFFENSE,CRIMINAL SEXUAL ABUSE,2009,824,656,168
SEX OFFENSE,CRIMINAL SEXUAL ABUSE,2010,779,607,172
SEX OFFENSE,CRIMINAL SEXUAL ABUSE,2011,412,324,88
SEX OFFENSE,CRIMINAL SEXUAL ABUSE,2012,422,333,89
SEX OFFENSE,CRIMINAL SEXUAL ABUSE,2013,346,266,80
SEX OFFENSE,CRIMINAL SEXUAL ABUSE,2014,331,263,68
SEX OFFENSE,CRIMINAL SEXUAL ABUSE,2015,345,287,58
SEX OFFENSE,CRIMINAL SEXUAL ABUSE,2016,340,290,50
SEX OFFENSE,CRIMINAL SEXUAL ABUSE,2017,394,334,60
SEX OFFENSE,CRIMINAL SEXUAL ABUSE,2018,417,360,57
SEX OFFENSE,CRIMINAL TRANSMISSION OF HIV,2010,10,8,2
SEX OFFENSE,CRIMINAL TRANSMISSION OF HIV,2011,7,6,1
SEX OFFENSE,CRIMINAL TRANSMISSION OF HIV,2012,8,7,1
SEX OFFENSE,CRIMINAL TRANSMISSION OF HIV,2013,4,3,1
SEX OFFENSE,CRIMINAL TRANSMISSION OF HIV,2014,7,6,1
SEX OFFENSE,CRIMINAL TRANSMISSION OF HIV,2015,3,2,1
SEX OFFENSE,FORNICATION,2009,4,0,4
SEX OFFENSE,FORNICATION,2014,1,0,1
SEX OFFENSE,INDECENT SOLICITATION/ADULT,2008,6,4,2
SEX OFFENSE,INDECENT SOLICITATION/ADULT,2009,6,4,2
SEX OFFENSE,INDECENT SOLICITATION/ADULT,2010,4,2,2
SEX OFFENSE,INDECENT SOLICITATION/ADULT,2012,2,1,1
SEX OFFENSE,INDECENT SOLICITATION/ADULT,2013,10,8,2
SEX OFFENSE,INDECENT SOLICITATION/ADULT,2014,5,3,2
SEX OFFENSE,INDECENT SOLICITATION/ADULT,2015,5,3,2
SEX OFFENSE,INDECENT SOLICITATION/ADULT,2017,5,4,1
SEX OFFENSE,INDECENT SOLICITATION/ADULT,2018,2,1,1
SEX OFFENSE,INDECENT SOLICITATION/CHILD,2008,80,56,24
SEX OFFENSE,INDECENT SOLICITATION/CHILD,2009,54,38,16
SEX OFFENSE,INDECENT SOLICITATION/CHILD,2010,39,27,12
SEX OFFENSE,INDECENT SOLICITATION/CHILD,2011,34,24,10
SEX OFFENSE,INDECENT SOLICITATION/CHILD,2012,26,21,5
SEX OFFENSE,INDECENT SOLICITATION/CHILD,2013,38,34,4
SEX OFFENSE,INDECENT SOLICITATION/CHILD,2014,21,17,4
SEX OFFENSE,INDECENT SOLICITATION/CHILD,2015,20,17,3
SEX OFFENSE,INDECENT SOLICITATION/CHILD,2016,29,25,4
SEX OFFENSE,INDECENT SOLICITATION/CHILD,2017,26,21,5
SEX OFFENSE,OTHER,2008,48,38,10
SEX OFFENSE,OTHER,2009,114,32,82
SEX OFFENSE,OTHER,2010,72,53,19
SEX OFFENSE,OTHER,2011,29,15,14
SEX OFFENSE,OTHER,2012,36,28,8
SEX OFFENSE,OTHER,2013,40,31,9
SEX OFFENSE,OTHER,2014,45,36,9
SEX OFFENSE,OTHER,2015,46,37,9
SEX OFFENSE,OTHER,2016,38,36,2
SEX OFFENSE,OTHER,2017,41,37,4
SEX OFFENSE,OTHER,2018,57,53,4
SEX OFFENSE,PUBLIC INDECENCY,2008,850,482,368
SEX OFFENSE,PUBLIC INDECENCY,2009,660,288,372
SEX OFFENSE,PUBLIC INDECENCY,2010,579,294,285
SEX OFFENSE,PUBLIC INDECENCY,2011,264,108,156
SEX OFFENSE,PUBLIC INDECENCY,2012,232,113,119
SEX OFFENSE,PUBLIC INDECENCY,2013,260,138,122
SEX OFFENSE,PUBLIC INDECENCY,2014,230,118,112
SEX OFFENSE,PUBLIC INDECENCY,2015,218,126,92
SEX OFFENSE,PUBLIC INDECENCY,2016,178,119,59
SEX OFFENSE,PUBLIC INDECENCY,2017,197,127,70
SEX OFFENSE,PUBLIC INDECENCY,2018,226,153,73
SEX OFFENSE,SEX RELATION IN FAMILY,2014,3,2,1
SEX OFFENSE,SEX RELATION IN FAMILY,2017,6,4,2
SEX OFFENSE,SEXUAL EXPLOITATION OF A CHILD,2008,70,56,14
SEX OFFENSE,SEXUAL EXPLOITATION OF A CHILD,2009,56,42,14
SEX OFFENSE,SEXUAL EXPLOITATION OF A CHILD,2010,66,49,17
SEX OFFENSE,SEXUAL EXPLOITATION OF A CHILD,2011,35,27,8
SEX OFFENSE,SEXUAL EXPLOITATION OF A CHILD,2012,31,26,5
SEX OFFENSE,SEXUAL EXPLOITATION OF A CHILD,2013,30,25,5
SEX OFFENSE,SEXUAL EXPLOITATION OF A CHILD,2014,27,25,2
SEX OFFENSE,SEXUAL EXPLOITATION OF A CHILD,2015,36,29,7
SEX OFFENSE,SEXUAL EXPLOITATION OF A CHILD,2016,27,19,8
SEX OFFENSE,SEXUAL EXPLOITATION OF A CHILD,2017,50,46,4
SEX OFFENSE,SEXUAL EXPLOITATION OF A CHILD,2018,48,42,6
STALKING,AGGRAVATED,2008,8,6,2
STALKING,AGGRAVATED,2009,10,4,6
STALKING,AGGRAVATED,2010,17,9,8
STALKING,AGGRAVATED,2011,17,6,11
STALKING,AGGRAVATED,2012,6,4,2
STALKING,AGGRAVATED,2013,5,2,3
STALKING,AGGRAVATED,2014,2,1,1
STALKING,AGGRAVATED,2015,3,1,2
STALKING,AGGRAVATED,2017,2,1,1
STALKING,CYBERSTALKING,2008,18,16,2
STALKING,CYBERSTALKING,2009,28,22,6
STALKING,CYBERSTALKING,2010,20,19,1
STALKING,CYBERSTALKING,2011,25,22,3
STALKING,CYBERSTALKING,2012,28,25,3
STALKING,CYBERSTALKING,2013,19,18,1
STALKING,CYBERSTALKING,2014,15,14,1
STALKING,CYBERSTALKING,2015,19,15,4
STALKING,CYBERSTALKING,2016,16,14,2
STALKING,CYBERSTALKING,2017,21,19,2
STALKING,CYBERSTALKING,2018,21,20,1
STALKING,SIMPLE,2008,344,300,44
STALKING,SIMPLE,2009,286,252,34
STALKING,SIMPLE,2010,305,266,39
STALKING,SIMPLE,2011,131,115,16
STALKING,SIMPLE,2012,141,119,22
STALKING,SIMPLE,2013,98,80,18
STALKING,SIMPLE,2014,94,77,17
STALKING,SIMPLE,2015,108,90,18
STALKING,SIMPLE,2016,114,108,6
STALKING,SIMPLE,2017,147,134,13
STALKING,SIMPLE,2018,142,137,5
STALKING,VIOLATION OF STALKING NO CONTACT ORDER,2012,32,21,11
STALKING,VIOLATION OF STALKING NO CONTACT ORDER,2013,24,16,8
STALKING,VIOLATION OF STALKING NO CONTACT ORDER,2014,19,12,7
STALKING,VIOLATION OF STALKING NO CONTACT ORDER,2015,19,12,7
STALKING,VIOLATION OF STALKING NO CONTACT ORDER,2016,11,8,3
STALKING,VIOLATION OF STALKING NO CONTACT ORDER,2017,14,6,8
STALKING,VIOLATION OF STALKING NO CONTACT ORDER,2018,24,12,12
THEFT,$500 AND UNDER,2008,50072,47478,2594
THEFT,$500 AND UNDER,2009,47800,45114,2686
THEFT,$500 AND UNDER,2010,46600,44142,2458
THEFT,$500 AND UNDER,2011,28998,27466,1532
THEFT,$500 AND UNDER,2012,29512,27885,1627
THEFT,$500 AND UNDER,2013,27786,26305,1481
THEFT,$500 AND UNDER,2014,28493,27141,1352
THEFT,$500 AND UNDER,2015,24471,23395,1076
THEFT,$500 AND UNDER,2016,23043,22085,958
THEFT,$500 AND UNDER,2017,24260,23311,949
THEFT,$500 AND UNDER,2018,22747,21864,883
THEFT,AGG: FINANCIAL ID THEFT,2008,596,584,12
THEFT,AGG: FINANCIAL ID THEFT,2009,458,456,2
THEFT,AGG: FINANCIAL ID THEFT,2010,368,361,7
THEFT,AGG: FINANCIAL ID THEFT,2011,166,156,10
THEFT,AGG: FINANCIAL ID THEFT,2012,170,160,10
THEFT,AGG: FINANCIAL ID THEFT,2013,110,106,4
THEFT,AGG: FINANCIAL ID THEFT,2014,13,12,1
THEFT,ATTEMPT FINANCIAL IDENTITY THEFT,2008,606,598,8
THEFT,ATTEMPT FINANCIAL IDENTITY THEFT,2009,614,608,6
THEFT,ATTEMPT FINANCIAL IDENTITY THEFT,2010,553,543,10
THEFT,ATTEMPT FINANCIAL IDENTITY THEFT,2011,279,274,5
THEFT,ATTEMPT FINANCIAL IDENTITY THEFT,2013,349,345,4
THEFT,ATTEMPT FINANCIAL IDENTITY THEFT,2014,51,50,1
THEFT,ATTEMPT THEFT,2008,1434,1056,378
THEFT,ATTEMPT THEFT,2009,1252,968,284
THEFT,ATTEMPT THEFT,2010,1299,1015,284
THEFT,ATTEMPT THEFT,2011,815,653,162
THEFT,ATTEMPT THEFT,2012,618,483,135
THEFT,ATTEMPT THEFT,2013,465,358,107
THEFT,ATTEMPT THEFT,2014,407,293,114
THEFT,ATTEMPT THEFT,2015,347,269,78
THEFT,ATTEMPT THEFT,2016,400,331,69
THEFT,ATTEMPT THEFT,2017,406,348,58
THEFT,ATTEMPT THEFT,2018,389,333,56
THEFT,DELIVERY CONTAINER THEFT,2008,76,68,8
THEFT,DELIVERY CONTAINER THEFT,2009,70,52,18
THEFT,DELIVERY CONTAINER THEFT,2010,77,63,14
THEFT,DELIVERY CONTAINER THEFT,2011,45,35,10
THEFT,DELIVERY CONTAINER THEFT,2012,52,43,9
THEFT,DELIVERY CONTAINER THEFT,2013,20,18,2
THEFT,DELIVERY CONTAINER THEFT,2014,40,34,6
THEFT,DELIVERY CONTAINER THEFT,2015,49,45,4
THEFT,DELIVERY CONTAINER THEFT,2016,31,27,4
THEFT,DELIVERY CONTAINER THEFT,2017,33,32,1
THEFT,DELIVERY CONTAINER THEFT,2018,34,31,3
THEFT,FINANCIAL ID THEFT: OVER $300,2008,6358,6240,118
THEFT,FINANCIAL ID THEFT: OVER $300,2009,5150,5082,68
THEFT,FINANCIAL ID THEFT: OVER $300,2010,4624,4573,51
THEFT,FINANCIAL ID THEFT: OVER $300,2011,2728,2689,39
THEFT,FINANCIAL ID THEFT: OVER $300,2012,3268,3222,46
THEFT,FINANCIAL ID THEFT: OVER $300,2013,3070,3013,57
THEFT,FINANCIAL ID THEFT: OVER $300,2014,412,401,11
THEFT,FINANCIAL ID THEFT:$300 &UNDER,2008,2124,2112,12
THEFT,FINANCIAL ID THEFT:$300 &UNDER,2009,2006,1998,8
THEFT,FINANCIAL ID THEFT:$300 &UNDER,2010,1804,1795,9
THEFT,FINANCIAL ID THEFT:$300 &UNDER,2011,932,926,6
THEFT,FINANCIAL ID THEFT:$300 &UNDER,2012,1091,1084,7
THEFT,FINANCIAL ID THEFT:$300 &UNDER,2013,913,894,19
THEFT,FINANCIAL ID THEFT:$300 &UNDER,2014,131,130,1
THEFT,FROM BUILDING,2008,34996,33934,1062
THEFT,FROM BUILDING,2009,30740,29876,864
THEFT,FROM BUILDING,2010,24336,23837,499
THEFT,FROM BUILDING,2011,13437,13129,308
THEFT,FROM BUILDING,2012,12083,11825,258
THEFT,FROM BUILDING,2013,11391,11127,264
THEFT,FROM BUILDING,2014,6082,5909,173
THEFT,FROM BUILDING,2015,8680,8535,145
THEFT,FROM BUILDING,2016,9305,9185,120
THEFT,FROM BUILDING,2017,10441,10314,127
THEFT,FROM BUILDING,2018,9710,9609,101
THEFT,FROM COIN-OP MACHINE/DEVICE,2008,122,106,16
THEFT,FROM COIN-OP MACHINE/DEVICE,2009,134,118,16
THEFT,FROM COIN-OP MACHINE/DEVICE,2010,90,81,9
THEFT,FROM COIN-OP MACHINE/DEVICE,2011,30,27,3
THEFT,FROM COIN-OP MACHINE/DEVICE,2012,29,27,2
THEFT,FROM COIN-OP MACHINE/DEVICE,2013,49,45,4
THEFT,FROM COIN-OP MACHINE/DEVICE,2016,23,20,3
THEFT,FROM COIN-OP MACHINE/DEVICE,2017,22,21,1
THEFT,FROM COIN-OP MACHINE/DEVICE,2018,18,17,1
THEFT,OVER $500,2008,47500,46182,1318
THEFT,OVER $500,2009,42381,41043,1338
THEFT,OVER $500,2010,41390,40144,1246
THEFT,OVER $500,2011,15714,15217,497
THEFT,OVER $500,2012,15955,15391,564
THEFT,OVER $500,2013,15471,14940,531
THEFT,OVER $500,2014,14735,14199,536
THEFT,OVER $500,2015,12565,12126,439
THEFT,OVER $500,2016,14236,13924,312
THEFT,OVER $500,2017,15125,14754,371
THEFT,OVER $500,2018,13951,13527,424
THEFT,POCKET-PICKING,2008,4218,4140,78
THEFT,POCKET-PICKING,2009,3718,3618,100
THEFT,POCKET-PICKING,2010,3505,3417,88
THEFT,POCKET-PICKING,2011,1810,1779,31
THEFT,POCKET-PICKING,2012,2401,2347,54
THEFT,POCKET-PICKING,2013,2305,2256,49
THEFT,POCKET-PICKING,2014,1708,1675,33
THEFT,POCKET-PICKING,2015,1634,1601,33
THEFT,POCKET-PICKING,2016,1867,1849,18
THEFT,POCKET-PICKING,2017,2223,2207,16
THEFT,POCKET-PICKING,2018,2203,2187,16
THEFT,PURSE-SNATCHING,2008,2268,2226,42
THEFT,PURSE-SNATCHING,2009,2052,1980,72
THEFT,PURSE-SNATCHING,2010,1774,1730,44
THEFT,PURSE-SNATCHING,2011,961,931,30
THEFT,PURSE-SNATCHING,2012,910,891,19
THEFT,PURSE-SNATCHING,2013,885,868,17
THEFT,PURSE-SNATCHING,2014,712,704,8
THEFT,PURSE-SNATCHING,2015,635,620,15
THEFT,PURSE-SNATCHING,2016,628,621,7
THEFT,PURSE-SNATCHING,2017,637,629,8
THEFT,PURSE-SNATCHING,2018,546,533,13
THEFT,RETAIL THEFT,2008,22440,9666,12774
THEFT,RETAIL THEFT,2009,22234,8074,14160
THEFT,RETAIL THEFT,2010,17503,7514,9989
THEFT,RETAIL THEFT,2011,9259,3434,5825
THEFT,RETAIL THEFT,2012,8955,3443,5512
THEFT,RETAIL THEFT,2013,8357,3184,5173
THEFT,RETAIL THEFT,2014,7909,2808,5101
THEFT,RETAIL THEFT,2015,8436,3508,4928
THEFT,RETAIL THEFT,2016,8795,3992,4803
THEFT,RETAIL THEFT,2017,10438,5524,4914
THEFT,RETAIL THEFT,2018,9953,5653,4300
WEAPONS VIOLATION,DEFACE IDENT MARKS OF FIREARM,2008,4,2,2
WEAPONS VIOLATION,DEFACE IDENT MARKS OF FIREARM,2009,4,0,4
WEAPONS VIOLATION,DEFACE IDENT MARKS OF FIREARM,2010,4,0,4
WEAPONS VIOLATION,DEFACE IDENT MARKS OF FIREARM,2013,5,0,5
WEAPONS VIOLATION,DEFACE IDENT MARKS OF FIREARM,2014,4,1,3
WEAPONS VIOLATION,DEFACE IDENT MARKS OF FIREARM,2015,5,0,5
WEAPONS VIOLATION,DEFACE IDENT MARKS OF FIREARM,2017,1,0,1
WEAPONS VIOLATION,DEFACE IDENT MARKS OF FIREARM,2018,3,0,3
WEAPONS VIOLATION,POSS FIREARM/AMMO:NO FOID CARD,2008,306,80,226
WEAPONS VIOLATION,POSS FIREARM/AMMO:NO FOID CARD,2009,378,68,310
WEAPONS VIOLATION,POSS FIREARM/AMMO:NO FOID CARD,2010,235,54,181
WEAPONS VIOLATION,POSS FIREARM/AMMO:NO FOID CARD,2011,118,25,93
WEAPONS VIOLATION,POSS FIREARM/AMMO:NO FOID CARD,2012,102,15,87
WEAPONS VIOLATION,POSS FIREARM/AMMO:NO FOID CARD,2013,108,15,93
WEAPONS VIOLATION,POSS FIREARM/AMMO:NO FOID CARD,2014,79,8,71
WEAPONS VIOLATION,POSS FIREARM/AMMO:NO FOID CARD,2015,68,13,55
WEAPONS VIOLATION,POSS FIREARM/AMMO:NO FOID CARD,2016,55,11,44
WEAPONS VIOLATION,POSS FIREARM/AMMO:NO FOID CARD,2017,65,10,55
WEAPONS VIOLATION,POSS FIREARM/AMMO:NO FOID CARD,2018,82,9,73
WEAPONS VIOLATION,RECKLESS FIREARM DISCHARGE,2008,160,106,54
WEAPONS VIOLATION,RECKLESS FIREARM DISCHARGE,2009,188,102,86
WEAPONS VIOLATION,RECKLESS FIREARM DISCHARGE,2010,153,84,69
WEAPONS VIOLATION,RECKLESS FIREARM DISCHARGE,2011,200,160,40
WEAPONS VIOLATION,RECKLESS FIREARM DISCHARGE,2012,97,56,41
WEAPONS VIOLATION,RECKLESS FIREARM DISCHARGE,2013,83,47,36
WEAPONS VIOLATION,RECKLESS FIREARM DISCHARGE,2014,112,66,46
WEAPONS VIOLATION,RECKLESS FIREARM DISCHARGE,2015,175,113,62
WEAPONS VIOLATION,RECKLESS FIREARM DISCHARGE,2016,238,196,42
WEAPONS VIOLATION,RECKLESS FIREARM DISCHARGE,2017,301,256,45
WEAPONS VIOLATION,RECKLESS FIREARM DISCHARGE,2018,539,492,47
WEAPONS VIOLATION,REGISTER OF SALES BY DEALER,2008,2,0,2
WEAPONS VIOLATION,UNLAWFUL POSS AMMUNITION,2008,92,20,72
WEAPONS VIOLATION,UNLAWFUL POSS AMMUNITION,2009,148,26,122
WEAPONS VIOLATION,UNLAWFUL POSS AMMUNITION,2010,217,40,177
WEAPONS VIOLATION,UNLAWFUL POSS AMMUNITION,2011,136,25,111
WEAPONS VIOLATION,UNLAWFUL POSS AMMUNITION,2012,132,29,103
WEAPONS VIOLATION,UNLAWFUL POSS AMMUNITION,2013,125,24,101
WEAPONS VIOLATION,UNLAWFUL POSS AMMUNITION,2014,111,21,90
WEAPONS VIOLATION,UNLAWFUL POSS AMMUNITION,2015,92,18,74
WEAPONS VIOLATION,UNLAWFUL POSS AMMUNITION,2016,67,20,47
WEAPONS VIOLATION,UNLAWFUL POSS AMMUNITION,2017,101,21,80
WEAPONS VIOLATION,UNLAWFUL POSS AMMUNITION,2018,99,23,76
WEAPONS VIOLATION,UNLAWFUL POSS OF HANDGUN,2008,4986,822,4164
WEAPONS VIOLATION,UNLAWFUL POSS OF HANDGUN,2009,5506,590,4916
WEAPONS VIOLATION,UNLAWFUL POSS OF HANDGUN,2010,4746,767,3979
WEAPONS VIOLATION,UNLAWFUL POSS OF HANDGUN,2011,2590,308,2282
WEAPONS VIOLATION,UNLAWFUL POSS OF HANDGUN,2012,2750,323,2427
WEAPONS VIOLATION,UNLAWFUL POSS OF HANDGUN,2013,2174,301,1873
WEAPONS VIOLATION,UNLAWFUL POSS OF HANDGUN,2014,2186,274,1912
WEAPONS VIOLATION,UNLAWFUL POSS OF HANDGUN,2015,2412,340,2072
WEAPONS VIOLATION,UNLAWFUL POSS OF HANDGUN,2016,2459,446,2013
WEAPONS VIOLATION,UNLAWFUL POSS OF HANDGUN,2017,3594,394,3200
WEAPONS VIOLATION,UNLAWFUL POSS OF HANDGUN,2018,3450,373,3077
WEAPONS VIOLATION,UNLAWFUL POSS OTHER FIREARM,2008,306,54,252
WEAPONS VIOLATION,UNLAWFUL POSS OTHER FIREARM,2009,328,44,284
WEAPONS VIOLATION,UNLAWFUL POSS OTHER FIREARM,2010,275,57,218
WEAPONS VIOLATION,UNLAWFUL POSS OTHER FIREARM,2011,149,27,122
WEAPONS VIOLATION,UNLAWFUL POSS OTHER FIREARM,2012,147,33,114
WEAPONS VIOLATION,UNLAWFUL POSS OTHER FIREARM,2013,141,29,112
WEAPONS VIOLATION,UNLAWFUL POSS OTHER FIREARM,2014,116,31,85
WEAPONS VIOLATION,UNLAWFUL POSS OTHER FIREARM,2015,90,21,69
WEAPONS VIOLATION,UNLAWFUL POSS OTHER FIREARM,2016,74,14,60
WEAPONS VIOLATION,UNLAWFUL POSS OTHER FIREARM,2017,104,25,79
WEAPONS VIOLATION,UNLAWFUL POSS OTHER FIREARM,2018,106,28,78
WEAPONS VIOLATION,UNLAWFUL SALE HANDGUN,2008,10,4,6
WEAPONS VIOLATION,UNLAWFUL SALE HANDGUN,2009,16,4,12
WEAPONS VIOLATION,UNLAWFUL SALE HANDGUN,2010,19,3,16
WEAPONS VIOLATION,UNLAWFUL SALE HANDGUN,2011,11,3,8
WEAPONS VIOLATION,UNLAWFUL SALE HANDGUN,2012,10,0,10
WEAPONS VIOLATION,UNLAWFUL SALE HANDGUN,2013,3,0,3
WEAPONS VIOLATION,UNLAWFUL SALE HANDGUN,2014,11,3,8
WEAPONS VIOLATION,UNLAWFUL SALE HANDGUN,2015,4,2,2
WEAPONS VIOLATION,UNLAWFUL SALE HANDGUN,2017,9,1,8
WEAPONS VIOLATION,UNLAWFUL SALE HANDGUN,2018,4,1,3
WEAPONS VIOLATION,UNLAWFUL SALE OTHER FIREARM,2008,2,0,2
WEAPONS VIOLATION,UNLAWFUL SALE OTHER FIREARM,2009,16,10,6
WEAPONS VIOLATION,UNLAWFUL SALE OTHER FIREARM,2010,15,9,6
WEAPONS VIOLATION,UNLAWFUL SALE OTHER FIREARM,2011,6,1,5
WEAPONS VIOLATION,UNLAWFUL SALE OTHER FIREARM,2018,5,3,2
WEAPONS VIOLATION,UNLAWFUL SALE/DELIVERY OF FIREARM AT SCHOOL,2008,38,14,24
WEAPONS VIOLATION,UNLAWFUL SALE/DELIVERY OF FIREARM AT SCHOOL,2009,24,6,18
WEAPONS VIOLATION,UNLAWFUL SALE/DELIVERY OF FIREARM AT SCHOOL,2010,23,6,17
WEAPONS VIOLATION,UNLAWFUL SALE/DELIVERY OF FIREARM AT SCHOOL,2011,8,2,6
WEAPONS VIOLATION,UNLAWFUL SALE/DELIVERY OF FIREARM AT SCHOOL,2012,3,1,2
WEAPONS VIOLATION,UNLAWFUL SALE/DELIVERY OF FIREARM AT SCHOOL,2013,2,1,1
WEAPONS VIOLATION,UNLAWFUL SALE/DELIVERY OF FIREARM AT SCHOOL,2014,2,0,2
WEAPONS VIOLATION,UNLAWFUL SALE/DELIVERY OF FIREARM AT SCHOOL,2016,1,0,1
WEAPONS VIOLATION,UNLAWFUL SALE/DELIVERY OF FIREARM AT SCHOOL,2018,3,2,1
WEAPONS VIOLATION,UNLAWFUL USE HANDGUN,2008,262,162,100
WEAPONS VIOLATION,UNLAWFUL USE HANDGUN,2009,278,122,156
WEAPONS VIOLATION,UNLAWFUL USE HANDGUN,2010,247,103,144
WEAPONS VIOLATION,UNLAWFUL USE HANDGUN,2011,148,53,95
WEAPONS VIOLATION,UNLAWFUL USE HANDGUN,2012,170,75,95
WEAPONS VIOLATION,UNLAWFUL USE HANDGUN,2013,128,61,67
WEAPONS VIOLATION,UNLAWFUL USE HANDGUN,2014,126,64,62
WEAPONS VIOLATION,UNLAWFUL USE HANDGUN,2015,152,100,52
WEAPONS VIOLATION,UNLAWFUL USE HANDGUN,2016,271,204,67
WEAPONS VIOLATION,UNLAWFUL USE HANDGUN,2017,324,234,90
WEAPONS VIOLATION,UNLAWFUL USE HANDGUN,2018,558,491,67
WEAPONS VIOLATION,UNLAWFUL USE OTHER DANG WEAPON,2008,1142,490,652
WEAPONS VIOLATION,UNLAWFUL USE OTHER DANG WEAPON,2009,988,238,750
WEAPONS VIOLATION,UNLAWFUL USE OTHER DANG WEAPON,2010,930,324,606
WEAPONS VIOLATION,UNLAWFUL USE OTHER DANG WEAPON,2011,375,91,284
WEAPONS VIOLATION,UNLAWFUL USE OTHER DANG WEAPON,2012,356,63,293
WEAPONS VIOLATION,UNLAWFUL USE OTHER DANG WEAPON,2013,356,69,287
WEAPONS VIOLATION,UNLAWFUL USE OTHER DANG WEAPON,2014,288,34,254
WEAPONS VIOLATION,UNLAWFUL USE OTHER DANG WEAPON,2015,264,33,231
WEAPONS VIOLATION,UNLAWFUL USE OTHER DANG WEAPON,2016,147,28,119
WEAPONS VIOLATION,UNLAWFUL USE OTHER DANG WEAPON,2017,100,17,83
WEAPONS VIOLATION,UNLAWFUL USE OTHER DANG WEAPON,2018,120,18,102
WEAPONS VIOLATION,UNLAWFUL USE OTHER FIREARM,2008,66,40,26
WEAPONS VIOLATION,UNLAWFUL USE OTHER FIREARM,2009,44,26,18
WEAPONS VIOLATION,UNLAWFUL USE OTHER FIREARM,2010,32,22,10
WEAPONS VIOLATION,UNLAWFUL USE OTHER FIREARM,2011,17,7,10
WEAPONS VIOLATION,UNLAWFUL USE OTHER FIREARM,2012,22,13,9
WEAPONS VIOLATION,UNLAWFUL USE OTHER FIREARM,2013,24,11,13
WEAPONS VIOLATION,UNLAWFUL USE OTHER FIREARM,2014,19,15,4
WEAPONS VIOLATION,UNLAWFUL USE OTHER FIREARM,2015,33,25,8
WEAPONS VIOLATION,UNLAWFUL USE OTHER FIREARM,2016,46,37,9
WEAPONS VIOLATION,UNLAWFUL USE OTHER FIREARM,2017,34,28,6
WEAPONS VIOLATION,UNLAWFUL USE OTHER FIREARM,2018,99,96,3
WEAPONS VIOLATION,UNLAWFUL USE/SALE AIR RIFLE,2008,274,84,190
WEAPONS VIOLATION,UNLAWFUL USE/SALE AIR RIFLE,2009,240,48,192
WEAPONS VIOLATION,UNLAWFUL USE/SALE AIR RIFLE,2010,218,58,160
WEAPONS VIOLATION,UNLAWFUL USE/SALE AIR RIFLE,2011,118,30,88
WEAPONS VIOLATION,UNLAWFUL USE/SALE AIR RIFLE,2012,108,29,79
WEAPONS VIOLATION,UNLAWFUL USE/SALE AIR RIFLE,2013,93,25,68
WEAPONS VIOLATION,UNLAWFUL USE/SALE AIR RIFLE,2014,50,11,39
WEAPONS VIOLATION,UNLAWFUL USE/SALE AIR RIFLE,2015,47,9,38
WEAPONS VIOLATION,UNLAWFUL USE/SALE AIR RIFLE,2016,37,9,28
WEAPONS VIOLATION,UNLAWFUL USE/SALE AIR RIFLE,2017,47,20,27
WEAPONS VIOLATION,UNLAWFUL USE/SALE AIR RIFLE,2018,26,7,19
ARSON,BY EXPLOSIVE,2008,16,16,0
ARSON,BY EXPLOSIVE,2009,8,8,0
ARSON,BY EXPLOSIVE,2012,4,4,0
ARSON,BY EXPLOSIVE,2013,2,2,0
ARSON,BY EXPLOSIVE,2014,4,4,0
ARSON,BY EXPLOSIVE,2015,4,4,0
ARSON,BY EXPLOSIVE,2016,3,3,0
ARSON,BY EXPLOSIVE,2017,3,3,0
ARSON,BY EXPLOSIVE,2018,3,3,0
ARSON,POS: CHEMICAL/DRY-ICE DEVICE,2011,1,1,0
ARSON,POS: CHEMICAL/DRY-ICE DEVICE,2016,1,1,0
ARSON,POS: EXPLOSIVE/INCENDIARY DEV,2012,2,2,0
ASSAULT,AGG PRO.EMP: OTHER FIREARM,2010,3,3,0
ASSAULT,AGG PRO.EMP: OTHER FIREARM,2012,1,1,0
ASSAULT,AGG PRO.EMP: OTHER FIREARM,2013,1,1,0
BATTERY,AGG PRO.EMP: HANDGUN,2015,1,1,0
BATTERY,AGG PRO.EMP: OTHER FIREARM,2008,8,8,0
BATTERY,AGG PRO.EMP: OTHER FIREARM,2015,1,1,0
BATTERY,AGGRAVATED DOMESTIC BATTERY,2009,2,2,0
BATTERY,AGGRAVATED DOMESTIC BATTERY: OTHER FIREARM,2010,7,7,0
BATTERY,AGGRAVATED DOMESTIC BATTERY: OTHER FIREARM,2011,2,2,0
BATTERY,AGGRAVATED OF A UNBORN CHILD,2011,1,1,0
BATTERY,AGGRAVATED OF A UNBORN CHILD,2012,2,2,0
BATTERY,AGGRAVATED OF A UNBORN CHILD,2014,2,2,0
BATTERY,AGGRAVATED OF A UNBORN CHILD,2015,6,6,0
BATTERY,AGGRAVATED OF A UNBORN CHILD,2018,1,1,0
BATTERY,AGGRAVATED PO: OTHER FIREARM,2009,2,2,0
BATTERY,AGGRAVATED PO: OTHER FIREARM,2017,1,1,0
BATTERY,AGGRAVATED: OTHER FIREARM,2012,17,17,0
BATTERY,AGGRAVATED: OTHER FIREARM,2013,9,9,0
BATTERY,AGGRAVATED: OTHER FIREARM,2014,17,17,0
BATTERY,AGGRAVATED: OTHER FIREARM,2015,8,8,0
BATTERY,AGGRAVATED: OTHER FIREARM,2016,16,16,0
BATTERY,AGGRAVATED: OTHER FIREARM,2017,25,25,0
BATTERY,OF UNBORN CHILD,2013,9,9,0
BATTERY,OF UNBORN CHILD,2016,2,2,0
BATTERY,OF UNBORN CHILD,2017,7,7,0
CONCEALED CARRY LICENSE VIOLATION,PROHIBITED PLACES,2014,1,1,0
CRIM SEXUAL ASSAULT,AGGRAVATED: OTHER DANG WEAPON,2018,14,14,0
CRIM SEXUAL ASSAULT,AGGRAVATED: OTHER FIREARM,2008,2,2,0
CRIM SEXUAL ASSAULT,AGGRAVATED: OTHER FIREARM,2018,1,1,0
CRIM SEXUAL ASSAULT,ATTEMPT AGG: HANDGUN,2011,5,5,0
CRIM SEXUAL ASSAULT,ATTEMPT AGG: HANDGUN,2016,1,1,0
CRIM SEXUAL ASSAULT,ATTEMPT AGG: KNIFE/CUT INSTR,2011,9,9,0
CRIM SEXUAL ASSAULT,ATTEMPT AGG: KNIFE/CUT INSTR,2015,3,3,0
CRIM SEXUAL ASSAULT,ATTEMPT AGG: KNIFE/CUT INSTR,2016,5,5,0
CRIM SEXUAL ASSAULT,ATTEMPT AGG: KNIFE/CUT INSTR,2017,1,1,0
CRIM SEXUAL ASSAULT,ATTEMPT AGG: KNIFE/CUT INSTR,2018,3,3,0
CRIM SEXUAL ASSAULT,ATTEMPT AGG: OTHER DANG WEAPON,2009,4,4,0
CRIM SEXUAL ASSAULT,ATTEMPT AGG: OTHER DANG WEAPON,2010,4,4,0
CRIM SEXUAL ASSAULT,ATTEMPT AGG: OTHER DANG WEAPON,2012,2,2,0
CRIM SEXUAL ASSAULT,ATTEMPT AGG: OTHER DANG WEAPON,2014,2,2,0
CRIM SEXUAL ASSAULT,ATTEMPT AGG: OTHER DANG WEAPON,2015,1,1,0
CRIM SEXUAL ASSAULT,ATTEMPT AGG: OTHER DANG WEAPON,2018,1,1,0
CRIM SEXUAL ASSAULT,ATTEMPT AGG: OTHER FIREARM,2009,2,2,0
CRIM SEXUAL ASSAULT,ATTEMPT AGG: OTHER FIREARM,2016,1,1,0
CRIMINAL DAMAGE,INSTITUTIONAL VANDALISM,2016,21,21,0
CRIMINAL DAMAGE,INSTITUTIONAL VANDALISM,2018,11,11,0
CRIMINAL DAMAGE,LIBRARY VANDALISM,2009,10,10,0
CRIMINAL DAMAGE,LIBRARY VANDALISM,2011,5,5,0
CRIMINAL DAMAGE,LIBRARY VANDALISM,2012,1,1,0
CRIMINAL DAMAGE,LIBRARY VANDALISM,2013,1,1,0
CRIMINAL DAMAGE,LIBRARY VANDALISM,2015,4,4,0
CRIMINAL DAMAGE,LIBRARY VANDALISM,2016,2,2,0
CRIMINAL DAMAGE,LIBRARY VANDALISM,2018,1,1,0
CRIMINAL DAMAGE,TO FIRE FIGHT.APP.EQUIP,2014,5,5,0
CRIMINAL DAMAGE,TO FIRE FIGHT.APP.EQUIP,2017,4,4,0
CRIMINAL DAMAGE,TO FIRE FIGHT.APP.EQUIP,2018,4,4,0
DECEPTIVE PRACTICE,AGGRAVATED COMPUTER TAMPERING,2008,2,2,0
DECEPTIVE PRACTICE,AGGRAVATED COMPUTER TAMPERING,2011,2,2,0
DECEPTIVE PRACTICE,AGGRAVATED COMPUTER TAMPERING,2012,1,1,0
DECEPTIVE PRACTICE,AGGRAVATED COMPUTER TAMPERING,2015,2,2,0
DECEPTIVE PRACTICE,AGGRAVATED COMPUTER TAMPERING,2016,2,2,0
DECEPTIVE PRACTICE,AGGRAVATED COMPUTER TAMPERING,2017,5,5,0
DECEPTIVE PRACTICE,AGGRAVATED COMPUTER TAMPERING,2018,5,5,0
DECEPTIVE PRACTICE,ALTER COINS,2008,2,2,0
DECEPTIVE PRACTICE,ALTER COINS,2013,1,1,0
DECEPTIVE PRACTICE,ALTER COINS,2018,1,1,0
DECEPTIVE PRACTICE,COMPUTER FRAUD,2013,123,123,0
DECEPTIVE PRACTICE,COMPUTER FRAUD,2016,73,73,0
DECEPTIVE PRACTICE,COMPUTER FRAUD,2017,141,141,0
DECEPTIVE PRACTICE,COMPUTER FRAUD,2018,144,144,0
DECEPTIVE PRACTICE,DECEPTIVE COLLECTION PRACTICES,2018,30,30,0
DECEPTIVE PRACTICE,EMBEZZLEMENT,2016,16,16,0
DECEPTIVE PRACTICE,FINAN EXPLOIT-ELDERLY/DISABLED,2018,35,35,0
DECEPTIVE PRACTICE,FINANCIAL IDENTITY THEFT $300 AND UNDER,2012,6,6,0
DECEPTIVE PRACTICE,FINANCIAL IDENTITY THEFT $300 AND UNDER,2013,11,11,0
DECEPTIVE PRACTICE,FINANCIAL IDENTITY THEFT OVER $ 300,2010,5,5,0
DECEPTIVE PRACTICE,FINANCIAL IDENTITY THEFT OVER $ 300,2011,9,9,0
DECEPTIVE PRACTICE,FINANCIAL IDENTITY THEFT OVER $ 300,2012,8,8,0
DECEPTIVE PRACTICE,FINANCIAL IDENTITY THEFT OVER $ 300,2013,50,50,0
DECEPTIVE PRACTICE,ILLEGAL POSSESSION CASH CARD,2009,126,126,0
DECEPTIVE PRACTICE,IMPERSONATION,2017,10,10,0
DECEPTIVE PRACTICE,INSURANCE FRAUD,2010,14,14,0
DECEPTIVE PRACTICE,INSURANCE FRAUD,2013,6,6,0
DECEPTIVE PRACTICE,INSURANCE FRAUD,2016,2,2,0
DECEPTIVE PRACTICE,INSURANCE FRAUD,2017,1,1,0
DECEPTIVE PRACTICE,INSURANCE FRAUD,2018,4,4,0
DECEPTIVE PRACTICE,LIBRARY THEFT,2008,8,8,0
DECEPTIVE PRACTICE,LIBRARY THEFT,2009,6,6,0
DECEPTIVE PRACTICE,LIBRARY THEFT,2010,2,2,0
DECEPTIVE PRACTICE,PAY TV SERVICE OFFENSES,2010,13,13,0
DECEPTIVE PRACTICE,PAY TV SERVICE OFFENSES,2011,9,9,0
DECEPTIVE PRACTICE,PAY TV SERVICE OFFENSES,2012,6,6,0
DECEPTIVE PRACTICE,PAY TV SERVICE OFFENSES,2013,8,8,0
DECEPTIVE PRACTICE,PAY TV SERVICE OFFENSES,2014,13,13,0
DECEPTIVE PRACTICE,PAY TV SERVICE OFFENSES,2015,9,9,0
DECEPTIVE PRACTICE,PAY TV SERVICE OFFENSES,2016,2,2,0
DECEPTIVE PRACTICE,PAY TV SERVICE OFFENSES,2017,16,16,0
DECEPTIVE PRACTICE,PAY TV SERVICE OFFENSES,2018,12,12,0
DECEPTIVE PRACTICE,POSS. KEYS OR DEV.TO COIN MACH,2016,1,1,0
DECEPTIVE PRACTICE,"THEFT BY LESSEE,NON-VEH",2011,13,13,0
DECEPTIVE PRACTICE,"THEFT BY LESSEE,NON-VEH",2013,14,14,0
DECEPTIVE PRACTICE,"THEFT BY LESSEE,NON-VEH",2015,8,8,0
DECEPTIVE PRACTICE,"THEFT BY LESSEE,NON-VEH",2016,4,4,0
DECEPTIVE PRACTICE,"THEFT BY LESSEE,NON-VEH",2017,11,11,0
DECEPTIVE PRACTICE,UNLAWFUL USE OF A COMPUTER,2010,47,47,0
DECEPTIVE PRACTICE,UNLAWFUL USE OF A COMPUTER,2011,25,25,0
DECEPTIVE PRACTICE,UNLAWFUL USE OF A COMPUTER,2013,26,26,0
DECEPTIVE PRACTICE,UNLAWFUL USE OF A COMPUTER,2015,16,16,0
DECEPTIVE PRACTICE,UNLAWFUL USE OF A COMPUTER,2017,27,27,0
DECEPTIVE PRACTICE,UNLAWFUL USE OF A COMPUTER,2018,19,19,0
GAMBLING,BOLITA OR BOLI PUL/RUNNER,2009,2,2,0
HOMICIDE,INVOLUNTARY MANSLAUGHTER,2013,1,1,0
HUMAN TRAFFICKING,COMMERCIAL SEX ACTS,2016,2,2,0
HUMAN TRAFFICKING,COMMERCIAL SEX ACTS,2017,6,6,0
HUMAN TRAFFICKING,INVOLUNTARY SERVITUDE,2014,1,1,0
HUMAN TRAFFICKING,INVOLUNTARY SERVITUDE,2015,8,8,0
HUMAN TRAFFICKING,INVOLUNTARY SERVITUDE,2016,5,5,0
HUMAN TRAFFICKING,INVOLUNTARY SERVITUDE,2018,2,2,0
INTERFERENCE WITH PUBLIC OFFICER,BRIBERY,2018,1,1,0
INTERFERENCE WITH PUBLIC OFFICER,OFFICIAL MISCONDUCT,2013,1,1,0
INTERFERENCE WITH PUBLIC OFFICER,REFUSING TO AID AN OFFICER,2016,1,1,0
INTIMIDATION,COMPELLING CONFESSION,2008,4,4,0
INTIMIDATION,COMPELLING CONFESSION,2011,1,1,0
INTIMIDATION,COMPELLING CONFESSION,2012,1,1,0
INTIMIDATION,COMPELLING ORG MEMBERSHIP,2010,4,4,0
INTIMIDATION,COMPELLING ORG MEMBERSHIP,2011,5,5,0
INTIMIDATION,COMPELLING ORG MEMBERSHIP,2013,1,1,0
INTIMIDATION,COMPELLING ORG MEMBERSHIP,2016,1,1,0
INTIMIDATION,EDUCATIONAL INTIMIDAITON,2011,1,1,0
INTIMIDATION,EDUCATIONAL INTIMIDAITON,2013,1,1,0
INTIMIDATION,EDUCATIONAL INTIMIDAITON,2015,2,2,0
INTIMIDATION,EDUCATIONAL INTIMIDAITON,2017,1,1,0
INTIMIDATION,EDUCATIONAL INTIMIDAITON,2018,1,1,0
INTIMIDATION,EXTORTION,2016,32,32,0
INTIMIDATION,EXTORTION,2017,60,60,0
INTIMIDATION,EXTORTION,2018,76,76,0
INTIMIDATION,INTIMIDATION OF LAW ENFORCEMENT OFFICIAL,2017,1,1,0
INTIMIDATION,INTIMIDATION OF LAW ENFORCEMENT OFFICIAL,2018,2,2,0
KIDNAPPING,AGGRAVATED,2016,7,7,0
KIDNAPPING,AGGRAVATED,2017,7,7,0
KIDNAPPING,FORCIBLE DETENTION,2011,2,2,0
KIDNAPPING,FORCIBLE DETENTION,2013,2,2,0
KIDNAPPING,FORCIBLE DETENTION,2014,2,2,0
KIDNAPPING,FORCIBLE DETENTION,2015,3,3,0
KIDNAPPING,FORCIBLE DETENTION,2016,3,3,0
KIDNAPPING,FORCIBLE DETENTION,2018,1,1,0
KIDNAPPING,KIDNAPPING,2014,14,14,0
KIDNAPPING,KIDNAPPING,2018,12,12,0
KIDNAPPING,UNLAWFUL INTERFERE/VISITATION,2008,86,86,0
KIDNAPPING,UNLAWFUL INTERFERE/VISITATION,2009,82,82,0
KIDNAPPING,UNLAWFUL INTERFERE/VISITATION,2010,97,97,0
KIDNAPPING,UNLAWFUL INTERFERE/VISITATION,2012,72,72,0
KIDNAPPING,UNLAWFUL INTERFERE/VISITATION,2014,60,60,0
KIDNAPPING,UNLAWFUL INTERFERE/VISITATION,2015,53,53,0
KIDNAPPING,UNLAWFUL INTERFERE/VISITATION,2017,48,48,0
MOTOR VEHICLE THEFT,"ATT: TRUCK, BUS, MOTOR HOME",2010,145,145,0
MOTOR VEHICLE THEFT,"ATT: TRUCK, BUS, MOTOR HOME",2013,11,11,0
MOTOR VEHICLE THEFT,"ATT: TRUCK, BUS, MOTOR HOME",2014,6,6,0
MOTOR VEHICLE THEFT,"ATT: TRUCK, BUS, MOTOR HOME",2015,11,11,0
MOTOR VEHICLE THEFT,"ATT: TRUCK, BUS, MOTOR HOME",2017,2,2,0
MOTOR VEHICLE THEFT,"ATT: TRUCK, BUS, MOTOR HOME",2018,4,4,0
MOTOR VEHICLE THEFT,"ATTEMPT: CYCLE, SCOOTER, BIKE NO VIN",2008,2,2,0
MOTOR VEHICLE THEFT,"ATTEMPT: CYCLE, SCOOTER, BIKE NO VIN",2009,2,2,0
MOTOR VEHICLE THEFT,"ATTEMPT: CYCLE, SCOOTER, BIKE NO VIN",2011,1,1,0
MOTOR VEHICLE THEFT,"ATTEMPT: CYCLE, SCOOTER, BIKE NO VIN",2012,2,2,0
MOTOR VEHICLE THEFT,"ATTEMPT: CYCLE, SCOOTER, BIKE NO VIN",2013,1,1,0
MOTOR VEHICLE THEFT,"ATTEMPT: CYCLE, SCOOTER, BIKE W-VIN",2008,12,12,0
MOTOR VEHICLE THEFT,"ATTEMPT: CYCLE, SCOOTER, BIKE W-VIN",2011,4,4,0
MOTOR VEHICLE THEFT,"ATTEMPT: CYCLE, SCOOTER, BIKE W-VIN",2014,4,4,0
MOTOR VEHICLE THEFT,"ATTEMPT: CYCLE, SCOOTER, BIKE W-VIN",2015,1,1,0
MOTOR VEHICLE THEFT,"ATTEMPT: CYCLE, SCOOTER, BIKE W-VIN",2016,6,6,0
MOTOR VEHICLE THEFT,"ATTEMPT: CYCLE, SCOOTER, BIKE W-VIN",2018,5,5,0
MOTOR VEHICLE THEFT,"CYCLE, SCOOTER, BIKE NO VIN",2008,22,22,0
MOTOR VEHICLE THEFT,"CYCLE, SCOOTER, BIKE NO VIN",2009,18,18,0
MOTOR VEHICLE THEFT,"CYCLE, SCOOTER, BIKE NO VIN",2013,11,11,0
MOTOR VEHICLE THEFT,"CYCLE, SCOOTER, BIKE NO VIN",2014,4,4,0
MOTOR VEHICLE THEFT,"CYCLE, SCOOTER, BIKE NO VIN",2016,8,8,0
MOTOR VEHICLE THEFT,"CYCLE, SCOOTER, BIKE NO VIN",2017,9,9,0
MOTOR VEHICLE THEFT,"THEFT/RECOVERY: CYCLE, SCOOTER, BIKE NO VIN",2009,2,2,0
MOTOR VEHICLE THEFT,"THEFT/RECOVERY: CYCLE, SCOOTER, BIKE NO VIN",2013,1,1,0
MOTOR VEHICLE THEFT,"THEFT/RECOVERY: CYCLE, SCOOTER, BIKE NO VIN",2015,1,1,0
NARCOTICS,FAIL REGISTER LIC:CONT SUBS,2009,2,2,0
NARCOTICS,FAIL REGISTER LIC:CONT SUBS,2014,1,1,0
NON - CRIMINAL,FOID - REVOCATION,2013,3,3,0
NON - CRIMINAL,FOID - REVOCATION,2014,10,10,0
NON-CRIMINAL,CONCEALED CARRY LICENSE REVOCATION,2014,1,1,0
NON-CRIMINAL,CONCEALED CARRY LICENSE REVOCATION,2016,1,1,0
NON-CRIMINAL,CONCEALED CARRY LICENSE REVOCATION,2017,1,1,0
NON-CRIMINAL,CONCEALED CARRY LICENSE REVOCATION,2018,1,1,0
NON-CRIMINAL,FOID - REVOCATION,2017,7,7,0
NON-CRIMINAL,FOUND PASSPORT,2013,1,1,0
NON-CRIMINAL,FOUND PASSPORT,2015,1,1,0
NON-CRIMINAL,FOUND PASSPORT,2016,1,1,0
NON-CRIMINAL,FOUND PASSPORT,2017,1,1,0
NON-CRIMINAL,GUN OFFENDER NOTIFICATION-NO CONTACT,2014,1,1,0
NON-CRIMINAL,GUN OFFENDER NOTIFICATION-NO CONTACT,2015,1,1,0
NON-CRIMINAL,GUN OFFENDER NOTIFICATION-NO CONTACT,2017,1,1,0
NON-CRIMINAL,LOST PASSPORT,2014,11,11,0
NON-CRIMINAL,LOST PASSPORT,2015,9,9,0
NON-CRIMINAL,LOST PASSPORT,2016,28,28,0
NON-CRIMINAL,LOST PASSPORT,2018,16,16,0
NON-CRIMINAL,NOTIFICATION OF STALKING - NO CONTACT ORDER,2014,2,2,0
NON-CRIMINAL,NOTIFICATION OF STALKING - NO CONTACT ORDER,2017,1,1,0
NON-CRIMINAL,NOTIFICATION OF STALKING - NO CONTACT ORDER,2018,3,3,0
NON-CRIMINAL (SUBJECT SPECIFIED),NOTIFICATION OF CIVIL NO CONTACT ORDER,2014,1,1,0
NON-CRIMINAL (SUBJECT SPECIFIED),NOTIFICATION OF CIVIL NO CONTACT ORDER,2016,1,1,0
OBSCENITY,OBSCENITY,2014,8,8,0
OBSCENITY,OBSCENITY,2016,9,9,0
OFFENSE INVOLVING CHILDREN,CONTRIBUTE CRIM DELINQUENCY JUVENILE,2008,8,8,0
OFFENSE INVOLVING CHILDREN,CONTRIBUTE CRIM DELINQUENCY JUVENILE,2016,1,1,0
OFFENSE INVOLVING CHILDREN,HARBOR RUNAWAY,2017,2,2,0
OTHER NARCOTIC VIOLATION,INTOXICATING COMPOUNDS,2018,1,1,0
OTHER OFFENSE,ABUSE/NEGLECT: CARE FACILITY,2008,18,18,0
OTHER OFFENSE,ABUSE/NEGLECT: CARE FACILITY,2010,11,11,0
OTHER OFFENSE,ABUSE/NEGLECT: CARE FACILITY,2011,4,4,0
OTHER OFFENSE,ABUSE/NEGLECT: CARE FACILITY,2013,1,1,0
OTHER OFFENSE,ABUSE/NEGLECT: CARE FACILITY,2016,3,3,0
OTHER OFFENSE,ABUSE/NEGLECT: CARE FACILITY,2017,6,6,0
OTHER OFFENSE,ANIMAL FIGHTING,2008,12,12,0
OTHER OFFENSE,ANIMAL FIGHTING,2012,1,1,0
OTHER OFFENSE,ANIMAL FIGHTING,2013,1,1,0
OTHER OFFENSE,ANIMAL FIGHTING,2017,1,1,0
OTHER OFFENSE,ANIMAL FIGHTING,2018,1,1,0
OTHER OFFENSE,COMPOUNDING A CRIME,2008,6,6,0
OTHER OFFENSE,COMPOUNDING A CRIME,2009,4,4,0
OTHER OFFENSE,COMPOUNDING A CRIME,2012,4,4,0
OTHER OFFENSE,DISCLOSE DV VICTIM LOCATION,2011,1,1,0
OTHER OFFENSE,EAVESDROPPING,2008,10,10,0
OTHER OFFENSE,EAVESDROPPING,2013,4,4,0
OTHER OFFENSE,EAVESDROPPING,2014,2,2,0
OTHER OFFENSE,EAVESDROPPING,2015,1,1,0
OTHER OFFENSE,EAVESDROPPING,2016,9,9,0
OTHER OFFENSE,EAVESDROPPING,2017,6,6,0
OTHER OFFENSE,EAVESDROPPING,2018,3,3,0
OTHER OFFENSE,HAZARDOUS MATERIALS VIOLATION,2011,7,7,0
OTHER OFFENSE,HAZARDOUS MATERIALS VIOLATION,2012,4,4,0
OTHER OFFENSE,HAZARDOUS MATERIALS VIOLATION,2014,2,2,0
OTHER OFFENSE,HAZARDOUS MATERIALS VIOLATION,2016,1,1,0
OTHER OFFENSE,INTERFERE W/ HIGHER EDUCATION,2017,1,1,0
OTHER OFFENSE,INTERFERE W/ HIGHER EDUCATION,2018,1,1,0
OTHER OFFENSE,MONEY LAUNDERING,2013,5,5,0
OTHER OFFENSE,MONEY LAUNDERING,2014,1,1,0
OTHER OFFENSE,MONEY LAUNDERING,2015,1,1,0
OTHER OFFENSE,MONEY LAUNDERING,2016,2,2,0
OTHER OFFENSE,MONEY LAUNDERING,2017,2,2,0
OTHER OFFENSE,OBSCENE TELEPHONE CALLS,2010,216,216,0
OTHER OFFENSE,OBSCENE TELEPHONE CALLS,2013,71,71,0
OTHER OFFENSE,OBSCENE TELEPHONE CALLS,2014,43,43,0
OTHER OFFENSE,OBSCENE TELEPHONE CALLS,2015,27,27,0
OTHER OFFENSE,OBSCENE TELEPHONE CALLS,2017,25,25,0
OTHER OFFENSE,OBSCENE TELEPHONE CALLS,2018,18,18,0
OTHER OFFENSE,OTHER ARSON/EXPLOSIVE INCIDENT,2012,8,8,0
OTHER OFFENSE,OTHER ARSON/EXPLOSIVE INCIDENT,2015,6,6,0
OTHER OFFENSE,OTHER ARSON/EXPLOSIVE INCIDENT,2017,3,3,0
OTHER OFFENSE,OTHER ARSON/EXPLOSIVE INCIDENT,2018,6,6,0
OTHER OFFENSE,SEX OFFENDER: PROHIBITED ZONE,2012,1,1,0
OTHER OFFENSE,VIOLATION GPS MONITORING DEVICE,2010,4,4,0
OTHER OFFENSE,VIOLATION GPS MONITORING DEVICE,2011,2,2,0
OTHER OFFENSE,VIOLATION OF SMOKING BAN,2015,3,3,0
PUBLIC PEACE VIOLATION,ARMED VIOLENCE,2014,2,2,0
PUBLIC PEACE VIOLATION,INTERFERE W/ EMERGENCY EQUIP,2008,4,4,0
PUBLIC PEACE VIOLATION,INTERFERE W/ EMERGENCY EQUIP,2012,1,1,0
PUBLIC PEACE VIOLATION,INTERFERE W/ EMERGENCY EQUIP,2013,1,1,0
PUBLIC PEACE VIOLATION,INTERFERE W/ EMERGENCY EQUIP,2014,2,2,0
PUBLIC PEACE VIOLATION,INTERFERE W/ EMERGENCY EQUIP,2016,1,1,0
PUBLIC PEACE VIOLATION,INTERFERE W/ EMERGENCY EQUIP,2017,2,2,0
PUBLIC PEACE VIOLATION,LOOTING,2008,2,2,0
PUBLIC PEACE VIOLATION,LOOTING,2010,2,2,0
PUBLIC PEACE VIOLATION,PUBLIC DEMONSTRATION,2018,4,4,0
ROBBERY,ARMED: OTHER FIREARM,2018,29,29,0
ROBBERY,ATTEMPT: ARMED-OTHER FIREARM,2010,24,24,0
ROBBERY,ATTEMPT: ARMED-OTHER FIREARM,2016,14,14,0
ROBBERY,ATTEMPT: ARMED-OTHER FIREARM,2018,7,7,0
SEX OFFENSE,ATT AGG CRIMINAL SEXUAL ABUSE,2008,6,6,0
SEX OFFENSE,ATT AGG CRIMINAL SEXUAL ABUSE,2014,4,4,0
SEX OFFENSE,ATT AGG CRIMINAL SEXUAL ABUSE,2016,3,3,0
SEX OFFENSE,ATT CRIM SEXUAL ABUSE,2018,30,30,0
SEX OFFENSE,BIGAMY,2009,2,2,0
SEX OFFENSE,BIGAMY,2012,3,3,0
SEX OFFENSE,BIGAMY,2015,2,2,0
SEX OFFENSE,CRIMINAL TRANSMISSION OF HIV,2008,12,12,0
SEX OFFENSE,CRIMINAL TRANSMISSION OF HIV,2009,8,8,0
SEX OFFENSE,CRIMINAL TRANSMISSION OF HIV,2016,3,3,0
SEX OFFENSE,CRIMINAL TRANSMISSION OF HIV,2017,5,5,0
SEX OFFENSE,CRIMINAL TRANSMISSION OF HIV,2018,2,2,0
SEX OFFENSE,INDECENT SOLICITATION/ADULT,2011,2,2,0
SEX OFFENSE,INDECENT SOLICITATION/ADULT,2016,4,4,0
SEX OFFENSE,INDECENT SOLICITATION/CHILD,2018,18,18,0
SEX OFFENSE,SEX RELATION IN FAMILY,2008,4,4,0
SEX OFFENSE,SEX RELATION IN FAMILY,2009,4,4,0
SEX OFFENSE,SEX RELATION IN FAMILY,2011,5,5,0
SEX OFFENSE,SEX RELATION IN FAMILY,2012,3,3,0
SEX OFFENSE,SEX RELATION IN FAMILY,2013,3,3,0
SEX OFFENSE,SEX RELATION IN FAMILY,2015,3,3,0
SEX OFFENSE,SEX RELATION IN FAMILY,2016,1,1,0
STALKING,AGGRAVATED,2016,1,1,0
STALKING,AGGRAVATED,2018,2,2,0
STALKING,VIOLATION OF STALKING NO CONTACT ORDER,2011,8,8,0
THEFT,ATTEMPT FINANCIAL IDENTITY THEFT,2012,337,337,0
THEFT,FROM COIN-OP MACHINE/DEVICE,2014,28,28,0
THEFT,FROM COIN-OP MACHINE/DEVICE,2015,14,14,0
THEFT,THEFT RETAIL,2016,1,1,0
WEAPONS VIOLATION,DEFACE IDENT MARKS OF FIREARM,2011,1,1,0
WEAPONS VIOLATION,DEFACE IDENT MARKS OF FIREARM,2016,1,1,0
WEAPONS VIOLATION,UNLAWFUL SALE HANDGUN,2016,2,2,0
WEAPONS VIOLATION,UNLAWFUL SALE/DELIVERY OF FIREARM AT SCHOOL,2017,1,1,0
WEAPONS VIOLATION,USE OF METAL PIERCING BULLETS,2008,2,2,0
WEAPONS VIOLATION,USE OF METAL PIERCING BULLETS,2017,1,1,0
